abato	aba-to
abdiki	ab-di-ki
abdomeno	ab-do-me-no
abelo	abe-lo
abio	abio
abism'?	abis-m'
abismo	abis-mo
abomeno	abo-me-no
aboni	abo-ni
abonpago	abon-pa-go
abrikoto	ab-ri-ko-to
abrupta	ab-rup-ta
absciso	ab-sci-so
absido	ab-si-do
absinto	ab-sin-to
absoluta	ab-so-lu-ta
absolutan	ab-so-lu-t-an
absolute	ab-so-lu-te
absorbita	ab-sor-bi-ta
abstini	ab-sti-ni
abstrakta	ab-strak-ta
abstraktan	ab-strak-t-an
absurda	ab-sur-da
absurdan	ab-sur-d-an
absurdo	ab-sur-do
abunda	abun-da
abutilo	abu-ti-lo
acero	ace-ro
acetilo	ace-ti-lo
acida	aci-da
acidaĵo	aci-d-aĵo
acideco	aci-d-eco
acidtone	acid-tone
aĉa	aĉa
aĉan	aĉ-an
aĉeti	aĉe-ti
aĉetis	aĉe-t-is
aĉetus	aĉe-t-us
aĉkoloran	aĉ-ko-lo-r-an
aĉulo	aĉ-ulo
adamantino	ada-man-ti-no
adapti	adap-ti
adeptoj	adep-t-oj
adiabato	adi-aba-to
adiaŭ	adi-aŭ
adicii	adi-cii
adjektiva	ad-jek-ti-va
adjektivaj	ad-jek-ti-v-aj
adjektivoj	ad-jek-ti-v-oj
adjektivon	ad-jek-ti-v-on
adjutanto	ad-ju-tan-to
administra	ad-mi-ni-s-tra
administracio	ad-mi-ni-s-tra-cio
administri	ad-mi-ni-s-tri
admiri	ad-miri
admoni	ad-mo-ni
adolto	adol-to
adopti	adop-ti
adori	ado-ri
adreslibro	ad-res-li-bro
adreslongo	ad-res-longo
adreso	ad-reso
adresreĝistro	ad-res-re-ĝi-s-tro
adresspaco	ad-res-spa-co
adreszono	ad-res-zo-no
adverbo	ad-ver-bo
adverbon	ad-ver-b-on
advokato	ad-vo-ka-to
aero	aero
aeroplano	aero-pla-no
aerŝvela	aer-ŝve-la
aerumi	aer-umi
afabla	afa-b-la
afable	afa-b-le
afereto	afer-eto
afero	afero
aferoj	afer-oj
aferon	afer-on
afgano	af-ga-no
afiksoj	afik-s-oj
afiŝo	afi-ŝo
aflikti	aflik-ti
afranki	afran-ki
afrikato	af-ri-ka-to
afriko	af-ri-ko
agadi	ag-adi
agadis	ag-ad-is
agado	ag-ado
agadon	ag-ad-on
agantoj	ag-an-t-oj
agas	ag-as
agato	aga-to
agema	ag-ema
agemaj	ag-em-aj
agento	agen-to
agis	ag-is
agitado	agi-t-ado
agiti	agi-ti
agito	agi-to
aglo	aglo
agnoskas	ag-no-s-k-as
agon	ag-on
agordo	agor-do
agos	ag-os
agrabla	agra-b-la
agrablan	agra-b-l-an
agregato	ag-re-ga-to
agro	agro
agus	ag-us
ajlo	aj-lo
ajnismo	ajn-ismo
ajnisto	ajn-isto
ajnuoj	aj-nu-oj
aĵoj	aĵ-oj
akademia	aka-de-mia
akademio	aka-de-mio
akceli	ak-ce-li
akcento	ak-cen-to
akceptas	ak-cep-t-as
akcepteblaj	ak-cep-t-eb-l-aj
akcepti	ak-cep-ti
akceptita	ak-cep-t-ita
akceptite	ak-cep-t-ite
akceptos	ak-cep-t-os
akceptu	ak-cep-tu
akcidento	ak-ci-den-to
akcio	ak-cio
akirado	akir-ado
akireblaj	akir-eb-l-aj
akiri	akiri
akiro	akiro
akno	ak-no
akompani	akom-pa-ni
akordo	akor-do
akra	akra
akredito	ak-re-di-to
akrido	akri-do
akrobato	ak-ro-ba-to
akso	ak-so
aktiva	ak-ti-va
akto	ak-to
aktoj	ak-t-oj
aktoro	ak-to-ro
aktuala	ak-tu-a-la
akumulo	aku-mu-lo
akurata	aku-ra-ta
akuŝistino	aku-ŝ-ist-ino
akuzativo	aku-za-ti-vo
akuzi	aku-zi
akvo	ak-vo
akvoblua	ak-vo-blua
akvodislimo	ak-vo-dis-li-mo
akvomelono	ak-vo-me-lo-no
akvon	ak-v-on
akvotreti	ak-vo-treti
alarmo	alar-mo
alaŭdfalko	alaŭd-fal-ko
alaŭdo	alaŭ-do
albumo	al-bu-mo
aldona	al-do-na
aldonaj	al-do-n-aj
aldonante	al-do-n-an-te
aldonas	al-do-n-as
aldoni	al-do-ni
aldoniĝas	al-do-n-iĝ-as
aldonis	al-do-n-is
aldonita	al-do-n-ita
aldonitan	al-do-n-it-an
aldono	al-do-no
aldonoj	al-do-n-oj
aldonon	al-do-n-on
aldonos	al-do-n-os
aldonu	al-do-nu
aleĉjo	ale-ĉjo
aleo	aleo
alesti	ales-ti
alfabetan	al-fa-be-t-an
alfabeto	al-fa-be-to
alfabetorda	al-fa-be-tor-da
alflugi	al-flu-gi
algo	al-go
alia	alia
aliaj	ali-aj
alian	ali-an
alie	alie
aliflanke	ali-flan-ke
alifoje	ali-foje
aligatoro	ali-ga-to-ro
aligi	aligi
aligos	alig-os
aliĝas	al-iĝ-as
aliĝi	al-iĝi
aliĝis	al-iĝ-is
aliiĝintaj	ali-iĝ-in-t-aj
alikvoto	ali-k-vo-to
aliloke	ali-lo-ke
aliris	alir-is
alislange	ali-slan-ge
alitema	ali-te-ma
alivorte	ali-vorte
alkalkulitaj	al-kal-kul-it-aj
alkalkulos	al-kal-kul-os
alkape	al-ka-pe
alkoholo	al-ko-ho-lo
alkonduki	al-kon-du-ki
alkondukiĝas	al-kon-du-k-iĝ-as
alkondukita	al-kon-du-k-ita
alkondukitaj	al-kon-du-k-it-aj
alkutimigadus	al-ku-ti-m-ig-ad-us
alkutimiĝas	al-ku-ti-m-iĝ-as
allasantan	al-la-s-an-t-an
allogo	al-lo-go
almenaŭ	al-me-naŭ
almezuri	al-me-zuri
almiliti	al-mi-liti
almozdonantoj	al-moz-do-n-an-t-oj
almozi	al-mo-zi
almozo	al-mo-zo
almozpeti	al-moz-peti
alopato	alo-pa-to
alparolis	al-pa-rol-is
alpaŝadis	al-pa-ŝ-ad-is
alpaŝas	al-pa-ŝ-as
alportadis	al-por-t-ad-is
alportas	al-por-t-as
alportata	al-por-t-ata
alporti	al-por-ti
alportos	al-por-t-os
alportus	al-por-t-us
alpremo	al-pre-mo
alprenas	al-pre-n-as
alprenis	al-pre-n-is
alprenitaj	al-pre-n-it-aj
alproksimigus	al-prok-si-m-ig-us
alproksimiĝis	al-prok-si-m-iĝ-is
alproksimiĝos	al-prok-si-m-iĝ-os
alprunti	al-prun-ti
alsaltas	al-sal-t-as
alŝvebis	al-ŝve-b-is
alta	alta
altabla	al-ta-b-la
altaj	alt-aj
altaĵo	alt-aĵo
altan	alt-an
altaro	al-ta-ro
alte	alte
alteco	alt-eco
alteflugaj	alte-flu-g-aj
alternativo	al-ter-na-ti-vo
alterni	al-ter-ni
altranĉi	altran-ĉi
altrudi	altru-di
altruisto	al-tru-isto
aludi	alu-di
aludis	alu-d-is
aluditaj	alu-d-it-aj
alumeto	alu-me-to
aluminio	alu-mi-nio
alvenantoj	al-ve-n-an-t-oj
alvenas	al-ve-n-as
alveni	al-ve-ni
alvenis	al-ve-n-is
alvenos	al-ve-n-os
amanto	am-an-to
amara	ama-ra
amas	am-as
amasego	ama-s-ego
amasiĝado	ama-s-iĝ-ado
amasloĝeja	amas-lo-ĝ-eja
amaso	ama-so
amatore	ama-to-re
amatoreco	ama-to-r-eco
amatoro	ama-to-ro
amatoroj	ama-to-r-oj
ambasado	am-ba-s-ado
ambasadoro	am-ba-sa-do-ro
ambaŭ	am-baŭ
amdeklaro	am-de-kla-ro
amegas	am-eg-as
amendo	amen-do
amerika	ame-ri-ka
amerikanoj	ame-ri-ka-n-oj
ameriko	ame-ri-ko
amerikon	ame-ri-k-on
ametisto	ame-ti-s-to
amikeco	ami-k-eco
amikiĝema	ami-k-iĝ-ema
amikiĝis	ami-k-iĝ-is
amiko	ami-ko
amikoj	ami-k-oj
amikon	ami-k-on
amindumi	amin-d-umi
aminta	am-in-ta
amita	am-ita
amon	am-on
ampere	am-pe-re
ampleksan	am-plek-s-an
amplekso	am-plek-so
ampolo	am-po-lo
amuleto	amu-le-to
amuzi	amu-zi
anaĥoreto	ana-ĥo-reto
analizado	ana-li-z-ado
analizataj	ana-li-z-at-aj
analizi	ana-li-zi
analizis	ana-li-z-is
analizitaj	ana-li-z-it-aj
analizo	ana-li-zo
analizos	ana-li-z-os
anara	an-ara
anaro	an-aro
anaso	ana-so
anatemo	ana-te-mo
andujo	an-du-jo
anekdoto	anek-do-to
anemono	ane-mo-no
angilo	an-gi-lo
angla	an-gla
anglalingvan	an-gla-lin-g-v-an
anglan	an-gl-an
anglo	an-glo
anglujo	an-gl-ujo
angstromo	ang-s-tro-mo
angulo	an-gu-lo
anĝelo	an-ĝe-lo
animalo	ani-ma-lo
animblinda	anim-blinda
animhava	anim-ha-va
animo	ani-mo
ankaŭ	an-kaŭ
ankoraŭ	an-ko-raŭ
ankroŝnuro	an-kro-ŝnu-ro
anoncas	anon-c-as
anonci	anon-ci
anoncĵurnaloj	anonc-ĵur-na-l-oj
ansero	an-se-ro
anstataŭ	an-sta-taŭ
anstataŭigi	an-sta-taŭ-igi
anstataŭiĝas	an-sta-taŭ-iĝ-as
antarkto	an-tark-to
antaŭ	an-taŭ
antaŭa	an-taŭa
antaŭaj	an-taŭ-aj
antaŭan	an-taŭ-an
antaŭdiri	an-taŭ-diri
antaŭdiris	an-taŭ-dir-is
antaŭe	an-taŭe
antaŭen	an-taŭ-en
antaŭi	an-taŭi
antaŭjuĝoj	an-taŭ-ju-ĝ-oj
antaŭparolo	an-taŭ-pa-rolo
antaŭsentas	an-taŭ-sen-t-as
antaŭstarus	an-taŭ-sta-r-us
antaŭtuko	an-taŭ-tu-ko
antaŭuloj	an-taŭ-ul-oj
antaŭurbo	an-taŭ-ur-bo
antaŭvenis	an-taŭ-ve-n-is
antaŭvidi	an-taŭ-vi-di
antaŭvidis	an-taŭ-vi-d-is
anteco	ant-eco
antidoto	an-ti-do-to
antigo	ant-igo
antikristo	an-ti-kri-s-to
antinomio	an-ti-no-mio
antipatioj	an-ti-pa-ti-oj
antipoda	an-ti-po-da
antracito	an-tra-ci-to
aoristo	aori-s-to
aparato	apa-ra-to
aparaton	apa-ra-t-on
aparta	apar-ta
apartaj	apar-t-aj
apartamento	apar-ta-men-to
apartan	apar-t-an
aparte	apar-te
apartenaĵo	apar-te-n-aĵo
apartenas	apar-te-n-as
aparteni	apar-te-ni
apartenon	apar-te-n-on
apartenus	apar-te-n-us
apatio	apa-tio
apenaŭ	ape-naŭ
apendicito?	apen-di-c-ito
aperantaj	ape-r-an-t-aj
aperas	ape-r-as
aperi	ape-ri
aperinta	ape-r-in-ta
aperintaj	ape-r-in-t-aj
aperis	ape-r-is
apero	ape-ro
aperoj	ape-r-oj
aperon	ape-r-on
aperos	ape-r-os
aperturo	aper-tu-ro
aperus	ape-r-us
apetito	ape-ti-to
aplaŭdado	aplaŭ-d-ado
aplaŭdi	aplaŭ-di
apliki	apli-ki
apliko	apli-ko
aplombo	aplom-bo
apogbastonon	apog-ba-s-to-n-on
apogi	apo-gi
apogis	apo-g-is
apostolo	apo-s-to-lo
apoteko	apo-te-ko
apreco	apre-co
aprilo	apri-lo
apro	apro
aprobas	apro-b-as
aprobi	apro-bi
aprobo	apro-bo
aprobon	apro-b-on
apsido	ap-si-do
apud	apud
apudĉambro	apud-ĉam-bro
apuddiga	apud-diga
apude	apude
apudĵeto	apud-ĵe-to
arabĉevaloj	arab-ĉe-va-l-oj
araneo	ara-neo
aranĝas	aran-ĝ-as
aranĝata	aran-ĝ-ata
aranĝi	aran-ĝi
aranĝis	aran-ĝ-is
aranĝita	aran-ĝ-ita
aranĝo	aran-ĝo
aranĝon	aran-ĝ-on
aranĝos	aran-ĝ-os
arbaro	arb-aro
arbaron	arb-ar-on
arbetaĵmanteloj	arbe-taĵ-man-te-l-oj
arbetaĵo	arbe-t-aĵo
arbeto	arb-eto
arbgregoj	arb-gre-g-oj
arbhava	arb-ha-va
arbitra	ar-bi-tra
arbitre	ar-bi-tre
arbitro	ar-bi-tro
arbitron	ar-bi-tr-on
arbkavaĵo	arb-ka-v-aĵo
arbo	arbo
arda	ar-da
arestis	ares-t-is
arestitajn	ares-t-it-ajn
arestito	ares-t-ito
arestitoj	ares-t-it-oj
arestitojn	ares-t-it-ojn
arestiton	ares-t-it-on
arestos	ares-t-os
argano	ar-ga-no
argilo	ar-gi-lo
argumentoj	ar-gu-men-t-oj
arĝento	ar-ĝen-to
arido	ari-do
ariĝo	ar-iĝo
aristo	ari-s-to
aristokrato	ari-s-to-kra-to
arkaikiĝis	ar-ka-i-k-iĝ-is
arkaĵhava	ar-kaĵ-ha-va
arkaĵo	ar-k-aĵo
arkis	ar-k-is
arko	ar-ko
armeo	ar-meo
armi	ar-mi
armilo	ar-mi-lo
armo	ar-mo
aroganto	aro-gan-to
aromato	aro-ma-to
arta	ar-ta
artaj	ar-t-aj
artan	ar-t-an
arte	ar-te
arterio	ar-te-rio
artifika	ar-tifi-ka
artiklo	ar-ti-klo
artiko	ar-ti-ko
artikolo	ar-ti-ko-lo
artikoloj	ar-ti-ko-l-oj
arto	ar-to
ascenda	as-cen-da
asekuri	ase-ku-ri
asembleo	asem-bleo
asertas	aser-t-as
aserti	aser-ti
asfalto	as-fal-to
asimileblaj	asi-mi-l-eb-l-aj
asimilita	asi-mi-l-ita
asimptoto	asimp-to-to
asisti	asi-s-ti
asizjuĝistaron	asiz-ju-ĝ-ist-ar-on
askarido	as-ka-ri-do
asketo	as-ke-to
asocio	aso-cio
aspektas	as-pek-t-as
aspekti	as-pek-ti
aspektis	as-pek-t-is
aspekto	as-pek-to
aspido	as-pi-do
atakanto	ata-kan-to
atakanton	ata-kan-t-on
atakaton	ata-k-at-on
ataki	ata-ki
atakoj	ata-k-oj
atendado	aten-d-ado
atendante	aten-d-an-te
atendantoj	aten-d-an-t-oj
atendi	aten-di
atendis	aten-d-is
atendo	aten-do
atendos	aten-d-os
atendu	aten-du
atenta	aten-ta
atentas	aten-t-as
atentata	aten-t-ata
atente	aten-te
atentema	aten-te-ma
atenti	aten-ti
atentigis	aten-t-ig-is
atentigu	aten-t-igu
atentinda	aten-t-inda
atentindan	aten-t-ind-an
atentitaj	aten-t-it-aj
atento	aten-to
atenton	aten-t-on
atentos	aten-t-os
atentu	aten-tu
atesti	ates-ti
atingas	atin-g-as
atingebla	atin-g-eb-la
atingeblecon	atin-g-eb-l-ec-on
atingi	atin-gi
atingis	atin-g-is
atingita	atin-g-ita
atingon	atin-g-on
atingos	atin-g-os
atingota	atin-go-ta
atlantiko	at-lan-ti-ko
atlanto	at-lan-to
atleto	at-le-to
atmosfero	at-mo-s-fe-ro
âtomato	âto-ma-to
atomo	ato-mo
âtoritato	âto-ri-ta-to
aŭdaca	aŭ-da-ca
aŭdadis	aŭ-d-ad-is
aŭdante	aŭ-d-an-te
aŭdas	aŭ-d-as
aŭdeblas	aŭ-d-eb-l-as
aŭdeble	aŭ-d-eb-le
aŭdi	aŭ-di
aŭdiĝas	aŭ-d-iĝ-as
aŭdis	aŭ-d-is
aŭditaj	aŭ-d-it-aj
aŭdos	aŭ-d-os
aŭgusto	aŭ-gu-s-to
aŭkcio	aŭk-cio
aŭskultantoj	aŭ-s-kul-t-an-t-oj
aŭskultas	aŭ-s-kul-t-as
aŭskulti	aŭ-s-kul-ti
aŭstralio	aŭ-s-tra-lio
aŭŝvico	aŭ-ŝ-vi-co
aŭta	aŭ-ta
aŭte	aŭ-te
aŭto	aŭ-to
aŭtobuso	aŭ-to-bu-so
aŭtoj	aŭ-t-oj
aŭtomataĵoj	aŭ-to-ma-t-aĵ-oj
aŭtomate	aŭ-to-ma-te
aŭtomato	aŭ-to-ma-to
aŭtomobilo	aŭ-to-mo-bi-lo
aŭton	aŭ-t-on
aŭtopordon	aŭ-to-por-d-on
aŭtoritata	aŭ-to-ri-ta-ta
aŭtoritataj	aŭ-to-ri-ta-t-aj
aŭtoritate	aŭ-to-ri-ta-te
aŭtoritato	aŭ-to-ri-ta-to
aŭtoritatoj	aŭ-to-ri-ta-t-oj
aŭtoro	aŭ-to-ro
aŭtoroj	aŭ-to-r-oj
aŭtuno	aŭ-tu-no
avantaĝo	avan-ta-ĝo
avantaĝon	avan-ta-ĝ-on
avara	ava-ra
avaro	ava-ro
avarulo	ava-r-ulo
avĉjon	av-ĉjon
aveno	ave-no
aventurema	aven-tu-r-ema
aventuro	aven-tu-ro
aventuroj	aven-tu-r-oj
aventuron	aven-tu-r-on
avenuo	ave-nuo
avertas	aver-t-as
averti	aver-ti
aviadile	avi-ad-ile
aviadilo	avi-ad-ilo
aviadiloj	avi-ad-il-oj
aviadilon	avi-ad-il-on
aviado	avi-ado
avida	avi-da
avino	avi-no
avio	avio
avokado	avo-ka-do
azeno	aze-no
azerbajĝana	azer-baj-ĝa-na
azilo	azi-lo
azio	azio
azotacido	azo-t-aci-do
azoto	azo-to
babiladis	ba-bi-l-ad-is
babilado	ba-bi-l-ado
babilema	ba-bi-l-ema
babilis	ba-bi-l-is
babilo	ba-bi-lo
bacilo	ba-ci-lo
bacon	ba-c-on
bagatela	ba-ga-te-la
bagatelo	ba-ga-te-lo
bagateloj	ba-ga-te-l-oj
bagatelon	ba-ga-te-l-on
bagdadon	bag-dad-on
bajoneto	ba-jo-ne-to
baki	ba-ki
bakita	ba-k-ita
bakterio	bak-te-rio
balaaĵĉaristo	ba-la-aĵ-ĉa-r-isto
balado	ba-la-do
balai	ba-lai
balancĉevalojn	ba-lanc-ĉe-va-l-ojn
balanci	ba-lan-ci
balasto	ba-la-s-to
balaston	ba-la-s-t-on
balbuti	bal-bu-ti
baldaŭ	bal-daŭ
balenosto	ba-le-no-s-to
balisto	ba-li-s-to
balo	ba-lo
balono	ba-lo-no
baloti	ba-lo-ti
baloto	ba-lo-to
balzama	bal-za-ma
bambuo	bam-buo
banalaj	ba-na-l-aj
banano	ba-na-no
banĉambroj	ban-ĉam-br-oj
bandaĝo	ban-da-ĝo
bandito	ban-di-to
bando	ban-do
bani	ba-ni
banko	ban-ko
bankrotaranĝo?	ban-kro-t-aran-ĝo
bankroto	ban-kro-to
banto	ban-to
baptano	bap-ta-no
bapti	bap-ti
baptofilo	bap-to-fi-lo
baptopatro	bap-to-pa-tro
barakti	ba-rak-ti
barbaro	bar-ba-ro
barbiro	bar-biro
barbo	bar-bo
barelo	ba-re-lo
barilo	ba-r-ilo
barko	bar-ko
baro	baro
basko	ba-s-ko
basraj	bas-r-aj
bastoneto	ba-s-to-n-eto
bastono	ba-s-to-no
bataladi	ba-ta-l-adi
batalado	ba-ta-l-ado
batalados	ba-ta-l-ad-os
batalakiri	ba-ta-l-akiri
batalantoj	ba-ta-l-ant-oj
batalas	ba-ta-l-as
batali	ba-ta-li
batalilo	ba-ta-l-ilo
batalilon	ba-ta-l-il-on
batalŝminko	ba-tal-ŝmin-ko
batalus	ba-ta-l-us
batas	ba-t-as
bati	ba-ti
batis	ba-t-is
batisto	ba-ti-s-to
batita	ba-t-ita
baton	ba-t-on
batŝnuro	bat-ŝnu-ro
baza	ba-za
bazan	ba-z-an
bazareto	ba-za-r-eto
bazaro	ba-za-ro
bazarreto	ba-zar-reto
bazilo	ba-zi-lo
bazita	ba-z-ita
bazo	ba-zo
bazvortaro	baz-vort-aro
bebo	be-bo
bedaŭras	be-daŭ-r-as
bedaŭri	be-daŭ-ri
bedaŭrinda	be-daŭ-r-inda
bedaŭrindaĵon	be-daŭ-rin-d-aĵ-on
bedaŭrindan	be-daŭ-r-ind-an
bedaŭrinde	be-daŭ-r-inde
behemoto	be-he-mo-to
bejo	be-jo
beko	be-ko
bela	bela
beladono	bela-do-no
belaj	bel-aj
belan	bel-an
belanima	bel-ani-ma
belartoj	bel-art-oj
belaspekta	bel-as-pek-ta
bele	bele
beleco	bel-eco
belega	bel-ega
belegan	bel-eg-an
beletra	bele-tra
beletro	bele-tro
bellana	bel-la-na
belŝmiraĵo	bel-ŝmir-aĵo
belulajn	bel-ul-ajn
belulan	bel-ul-an
belulina	bel-ul-ina
belulinaj	bel-ul-in-aj
belulinajn	bel-ul-in-ajn
belulinan	bel-ul-in-an
beluline	bel-ul-ine
belulino	bel-ul-ino
belulinoj	bel-ul-in-oj
belulinojn	bel-ul-in-ojn
belulinon	bel-ul-in-on
belulo	bel-ulo
belulojn	bel-ul-ojn
bendo	ben-do
beni	be-ni
benkapogilo?	ben-ka-po-g-ilo
benketo	ben-k-eto
benko	ben-ko
benos	be-n-os
benzino	ben-zi-no
bergamoto	ber-ga-mo-to
berilo	be-ri-lo
bero	be-ro
besto	bes-to
bestoj	bes-t-oj
bestonomoj	bes-to-no-m-oj
beto	be-to
betulo	be-tu-lo
bezona	be-zo-na
bezonaj	be-zo-n-aj
bezonante	be-zo-n-an-te
bezonas	be-zo-n-as
bezonata	be-zo-n-ata
bezonataĵo	be-zo-na-t-aĵo
bezoni	be-zo-ni
bezonis	be-zo-n-is
bezono	be-zo-no
bezonoj	be-zo-n-oj
bezonos	be-zo-n-os
bezonus	be-zo-n-us
biblioteko	bi-b-li-o-te-ko
biblisciencon	bi-b-li-sci-en-c-on
biciklo	bi-ci-klo
bido	bido
bieno	bi-e-no
biero	bi-e-ro
bieron	bi-e-r-on
bifsteko	bif-ste-ko
bigoto	bi-go-to
bilardo	bi-lar-do
bildgalerioj	bild-ga-le-ri-oj
bildo	bil-do
bileto	bi-le-to
bileton	bi-le-t-on
bilo	bi-lo
bindi	bin-di
biogaso	bio-ga-so
birdido	bir-d-ido
birdo	bir-do
biskoto	bi-s-ko-to
biskvito	bi-s-k-vi-to
bismuton	bis-mu-t-on
bitlibro	bit-li-bro
bito	bito
bitokoj	bit-ok-oj
bitumo	bi-tu-mo
bizaro	bi-za-ro
blanka	blan-ka
blankaĵo	blan-k-aĵo
blasfemi	bla-s-fe-mi
blato	bla-to
bleki	ble-ki
blinda	blin-da
blinde	blin-de
blindigita	blin-d-ig-ita
bloko	blo-ko
blonda	blon-da
blondan	blon-d-an
blondulo	blon-d-ulo
blondulon	blon-d-ul-on
bloveksciti	blo-v-eks-ci-ti
bloveŝveli	blo-ve-ŝve-li
blovi	blo-vi
blovoŝvelas	blo-vo-ŝve-l-as
blua	blua
bluaj	blu-aj
bluzo	bluzo
boato	bo-ato
bofilo	bo-fi-lo
bofratino	bo-fra-ti-no
bofrato	bo-fra-to
bogefratoj	bo-ge-fra-t-oj
bogepatroj	bo-ge-pa-tr-oj
bohemo	bo-he-mo
bojaroj	bo-jar-oj
boji	bo-ji
bojkoto	boj-ko-to
boksganto	boks-gan-to
bolanta	bo-l-an-ta
boleto	bo-le-to
boli	bo-li
bolido	bo-li-do
bombono	bom-bo-no
bona	bona
bonaj	bon-aj
bonaĵo	bon-aĵo
bonan	bon-an
bone	bone
boneco	bon-eco
bonedukita	bon-edu-k-ita
bonega	bon-ega
bonegan	bon-eg-an
bonege	bon-ege
boneggustan	bon-eg-gu-s-t-an
bonekonata	bone-ko-n-ata
bonevino	bo-ne-vi-no
bonfaran	bon-fa-r-an
bongusta	bon-gu-s-ta
bonkora	bon-ko-ra
bonkore	bon-ko-re
bono	bono
bonodoro	bon-odo-ro
bonoj	bon-oj
bonsoneco	bon-so-n-eco
bonŝanca	bon-ŝan-ca
bontrovo	bon-tro-vo
bonvena	bon-ve-na
bonvolas	bon-vo-l-as
bonvoli	bon-vo-li
bonvolo	bon-vo-lo
bonvolu	bon-vo-lu
bonvolus	bon-vo-l-us
boparenco	bo-pa-ren-co
bopatrino	bo-pa-tri-no
bopatro	bo-pa-tro
bordo	bor-do
bordoj	bor-d-oj
bori	bo-ri
borso	bor-so
bosna	bos-na
botaniko	bo-ta-ni-ko
boteleto	bo-te-l-eto
botelo	bo-te-lo
botelon	bo-te-l-on
botisto	bo-t-isto
boto	bo-to
bovido	bo-v-ido
bovino	bo-vi-no
bovlo	bov-lo
bovo	bo-vo
braceleto	bra-ce-le-to
brakhorloĝon	brak-hor-lo-ĝ-on
brako	bra-ko
brakoj	bra-k-oj
brakseĝoj	brak-se-ĝ-oj
brakumi	bra-k-umi
branĉfaskon	branĉ-fa-s-k-on
branĉnesto	branĉ-nes-to
branĉo	bran-ĉo
brando	bran-do
brandon	bran-d-on
brasiko	bra-si-ko
bratislava	bra-ti-sla-va
brava	bra-va
bravulo	bra-v-ulo
brazilo	bra-zi-lo
breĉon	bre-ĉ-on
bredi	bre-di
Breĵnev	breĵ-nev
bremso	brem-so
breto	breto
breveto	bre-ve-to
brido	bri-do
brigado	bri-ga-do
brigantino	bri-gan-ti-no
brigo	bri-go
briĝo	bri-ĝo
briko	bri-ko
brilas	bri-l-as
brile	bri-le
brili	bri-li
brilo	bri-lo
brito	bri-to
brokanti	bro-kan-ti
brokanto	bro-kan-to
brokato	bro-ka-to
bronzo	bron-zo
broso	bro-so
broŝuro	bro-ŝu-ro
brovo	bro-vo
bruegon	bru-eg-on
brui	brui
bruli	bru-li
bruligi	bru-l-igi
brulo	brulo
brulstampi	brul-stam-pi
brulŝnuro	brul-ŝnu-ro
brulumo	bru-l-umo
brumo	brumo
bruna	bru-na
brunharan	brun-har-an
bruo	bruo
bruoj	bru-oj
bruon	bru-on
brusto	bru-s-to
brustŝvele	bru-st-ŝve-le
brutaro	bru-t-aro
bruto	bru-to
bubo	bu-bo
buboj	bu-b-oj
buĉi	bu-ĉi
buĉverŝu	buĉ-ver-ŝu
budĝeto	bud-ĝ-eto
budhanoj	bud-ha-n-oj
budho	bud-ho
budo	bu-do
buĝeto	bu-ĝe-to
bukedo	bu-ke-do
buklo	bu-klo
buko	bu-ko
bulbo	bul-bo
bulgaroj	bul-ga-r-oj
bulko	bul-ko
bulo	bu-lo
bulteno	bul-te-no
bulvardo	bul-var-do
bumo	bu-mo
burĝo	bur-ĝo
burĝono	bur-ĝo-no
buso	bu-so
buŝa	buŝa
buŝaj	buŝ-aj
buŝe	buŝe
buŝharmonikon	buŝ-har-mo-ni-k-on
buŝo	buŝo
buŝpeco	buŝ-pe-co
buŝplastro	buŝ-pla-s-tro
buŝpleno	buŝ-ple-no
buŝumo	buŝ-umo
butano	bu-ta-no
butero	bu-te-ro
butiko	bu-ti-ko
butono	bu-to-no
butonumi	bu-to-n-umi
cedadi	ce-d-adi
cedi	ce-di
cedilo	ce-di-lo
celadas	ce-l-ad-as
celado	ce-l-ado
celadon	ce-l-ad-on
celados	ce-l-ad-os
celas	ce-l-as
celo	ce-lo
celoj	ce-l-oj
celon	ce-l-on
cemento	ce-men-to
cenobito	ce-no-bi-to
cent	cent
centilitro	cen-ti-li-tro
centimetro	cen-ti-me-tro
centimo	cen-ti-mo
centjaro	cent-jaro
centjaroj	cent-jar-oj
cento	cen-to
centobla	cen-t-ob-la
centoblaj	cen-t-ob-l-aj
centoblajn	cen-t-ob-l-ajn
centoblan	cen-t-ob-l-an
centoble	cen-t-ob-le
centobleco	cen-t-ob-l-eco
centoblo	cen-t-ob-lo
centobloj	cen-t-ob-l-oj
centoblojn	cen-t-ob-l-ojn
centoblon	cen-t-ob-l-on
centoj	cen-t-oj
centon	cent-on
centonajn	cent-on-ajn
centone	cent-one
centonojn	cent-on-ojn
centopajn	cent-op-ajn
centope	cent-ope
centopo	cent-opo
centopojn	cent-op-ojn
centralo	cen-tra-lo
centro	cen-tro
cepo	ce-po
cerbklarecon	cerb-kla-r-ec-on
cerbo	cer-bo
cerbon	cer-b-on
certa	cer-ta
certaj	cer-t-aj
certe	cer-te
certeco	cer-t-eco
certecon	cer-t-ec-on
certigas	cer-t-ig-as
certigi	cer-t-igi
certiĝi	cer-t-iĝi
cervo	cer-vo
cetera	ce-te-ra
ceteraj	ce-te-r-aj
cetere	ce-te-re
cezaran	ce-za-r-an
cidaro	ci-da-ro
cifero	ci-fe-ro
ciferplato	ci-fer-plato
cigano	ci-ga-no
cigaredo	ci-ga-re-do
cigarejo	ci-ga-r-ejo
cigaringo	ci-gar-ingo
cigaro	ci-ga-ro
cigarujo	ci-ga-r-ujo
cigno	cig-no
cikado	ci-ka-do
cikatro	ci-ka-tro
ciklo	ci-klo
cikonio	ci-ko-nio
cilindrobloko	ci-lin-dro-blo-ko
cilindroforma	ci-lin-dro-for-ma
cinamo	ci-na-mo
cindro	cin-dro
cirkelo	cir-ke-lo
cirilaj	ci-ri-l-aj
cirklo	cir-klo
cirkludoj??	cir-klu-do-j?
cirkonstanco	cir-kon-stan-co
cirkonstancoj	cir-kon-stan-c-oj
cirkulero	cir-ku-le-ro
cirkuli	cir-ku-li
cirkumcido	cir-kum-ci-do
cirkvito	cir-k-vi-to
ciro	ciro
cisto	ci-s-to
citas	ci-t-as
citatoj	ci-t-at-oj
citi	ci-ti
citis	ci-t-is
citita	ci-t-ita
cito	ci-to
citos	ci-t-os
citrono	ci-tro-no
civila	ci-vi-la
civilizacio	ci-vi-li-za-cio
civilizacion	ci-vi-li-za-ci-on
civilizi	ci-vi-li-zi
civilizita	ci-vi-li-z-ita
civito	ci-vi-to
colo	co-lo
ĉagreni	ĉa-gre-ni
ĉambelano	ĉam-be-la-no
ĉambraĉo	ĉam-br-aĉo
ĉambristino	ĉam-br-ist-ino
ĉambro	ĉam-bro
ĉambron	ĉam-br-on
ĉampano	ĉam-pa-no
ĉapelo	ĉa-pe-lo
ĉapitro	ĉa-pi-tro
ĉapo	ĉa-po
ĉar	ĉar
ĉarlatano	ĉar-la-ta-no
ĉarma	ĉar-ma
ĉarmon	ĉar-m-on
ĉaro	ĉaro
ĉarpentisto	ĉar-pen-t-isto
ĉarumo	ĉa-r-umo
ĉasaĵo	ĉas-aĵo
ĉasakiro	ĉas-akiro
ĉashundo	ĉas-hun-do
ĉasi	ĉasi
ĉasion	ĉasi-on
ĉasleopardo	ĉas-le-o-par-do
ĉastafekta	ĉas-t-a-fek-ta
ĉeesti	ĉe-es-ti
ĉeestis	ĉe-es-t-is
ĉefa	ĉefa
ĉefaj	ĉef-aj
ĉefĉasisto	ĉef-ĉa-s-isto
ĉefe	ĉefe
ĉefepiskopo	ĉef-e-pi-s-ko-po
ĉefĝardenisto	ĉef-ĝar-de-n-isto
ĉeĥdevena	ĉeĥ-de-vena
ĉefo	ĉefo
ĉefoficejo	ĉef-ofi-c-ejo
ĉefurbon	ĉef-ur-b-on
ĉefverkoj	ĉef-ver-k-oj
ĉeko	ĉe-ko
ĉelo	ĉe-lo
ĉemizmaniko	ĉe-miz-ma-ni-ko
ĉemizo	ĉe-mi-zo
ĉeno	ĉe-no
ĉerizo	ĉe-ri-zo
ĉerko	ĉer-ko
ĉerpi	ĉer-pi
ĉerpis	ĉer-p-is
ĉerpu	ĉer-pu
ĉesi	ĉe-si
ĉesos	ĉe-s-os
ĉesus	ĉe-s-us
ĉevalaĉa	ĉe-va-l-aĉa
ĉevalaĉaj	ĉe-va-l-aĉ-aj
ĉevalaĉajn	ĉe-va-l-aĉ-ajn
ĉevalaĉan	ĉe-va-l-aĉ-an
ĉevalaĉo	ĉe-va-l-aĉo
ĉevalaĉoj	ĉe-va-l-aĉ-oj
ĉevalaĉojn	ĉe-va-l-aĉ-ojn
ĉevalaĉon	ĉe-va-l-aĉ-on
ĉevalido	ĉe-va-li-do
ĉevalo	ĉe-va-lo
ĉevaloj	ĉe-va-l-oj
ĉiam	ĉiam
ĉiamaj	ĉiam-aj
ĉiaokaze	ĉia-oka-ze
ĉiaspecaj	ĉia-spe-c-aj
ĉieaj	ĉie-aj
ĉiel	ĉiel
ĉielarko	ĉiel-ar-ko
ĉieliro	ĉiel-iro
ĉielo	ĉielo
ĉies	ĉies
ĉieseco	ĉies-eco
ĉiesulino	ĉies-ul-ino
ĉifi	ĉi-fi
ĉifoje	ĉi-foje
ĉifono	ĉi-fo-no
ĉikano	ĉi-ka-no
ĉilasta	ĉi-la-s-ta
ĉilo	ĉilo
ĉimatene	ĉi-ma-tene
ĉina	ĉi-na
ĉinĉilo	ĉin-ĉi-lo
ĉio	ĉio
ĉiom	ĉiom
ĉiomaj	ĉiom-aj
ĉiomanĝanta	ĉio-man-ĝ-an-ta
ĉiomo	ĉiomo
ĉion	ĉion
ĉiopova	ĉio-po-va
ĉioscia	ĉio-scia
ĉioscianta	ĉio-sci-an-ta
ĉirkaŭ	ĉir-kaŭ
ĉirkaŭaĵo	ĉir-kaŭ-aĵo
ĉirkaŭas	ĉir-kaŭ-as
ĉirkaŭfrazo	ĉir-kaŭ-fra-zo
ĉirkaŭmano	ĉir-kaŭ-ma-no
ĉirkaŭpreni	ĉir-kaŭ-pre-ni
ĉirkaŭskribi	ĉir-kaŭ-skri-bi
ĉirkaŭŝpinis	ĉir-kaŭ-ŝpi-n-is
ĉiu	ĉiu
ĉiuflanke	ĉiu-flan-ke
ĉiufoje	ĉiu-foje
ĉiuhoma	ĉiu-ho-ma
ĉiuhoman	ĉiu-ho-m-an
ĉiuj	ĉiuj
ĉiuĵaŭde	ĉiu-ĵaŭ-de
ĉiun	ĉiun
ĉiumomente	ĉiu-mo-men-te
ĉiuokaze	ĉiu-oka-ze
ĉiutaga	ĉiu-ta-ga
ĉiutagaj	ĉiu-ta-g-aj
ĉiutage	ĉiu-ta-ge
ĉokolado	ĉo-ko-la-do
ĉokoladoj	ĉo-ko-la-d-oj
ĉokoladon	ĉo-ko-la-d-on
Dafno	daf-no
daktilarbo	dak-til-arbo
daktilo	dak-ti-lo
damoj	da-m-oj
dancado	dan-c-ado
dancaj	dan-c-aj
dancas	dan-c-as
dancbiletoj	danc-bi-le-t-oj
dancpaŝoj	danc-pa-ŝ-oj
dancpavilono	danc-pa-vi-lo-no
dancŝuoj	danc-ŝu-oj
dancmuziko	danc-mu-zi-ko
danco	dan-co
dando	dan-do
danĝeraj	dan-ĝe-r-aj
danĝere	dan-ĝe-re
danĝero	dan-ĝe-ro
danĝeroj	dan-ĝe-r-oj
danĝerzonon	dan-ĝer-zo-n-on
dank'?	dan-k'
dankas	dan-k-as
dankegas	dan-k-eg-as
dankemon	dan-k-em-on
danki	dan-ki
dankinde	dan-k-inde
dankis	dan-k-is
danko	dan-ko
dankon	dan-k-on
danku	dan-ku
dano	da-no
dato	dato
daŭra	daŭ-ra
daŭras	daŭ-r-as
daŭre	daŭ-re
daŭri	daŭ-ri
daŭrigi	daŭ-r-igi
daŭrigis	daŭ-r-ig-is
daŭrigo	daŭ-r-igo
daŭrigos	daŭ-r-ig-os
daŭris	daŭ-r-is
daŭro	daŭ-ro
daŭron	daŭ-r-on
daŭros	daŭ-r-os
daŭrus	daŭ-r-us
davido	da-vi-do
debato	de-ba-to
debatos	de-ba-t-os
debeto	de-be-to
debilo	de-bi-lo
debito	de-bi-to
decembro	de-cem-bro
deci	de-ci
decidas	de-ci-d-as
decidi	de-ci-di
decidiĝas	de-ci-d-iĝ-as
decidis	de-ci-d-is
decidita	de-ci-d-ita
deciditan	de-ci-d-it-an
decidite	de-ci-d-ite
decido	de-ci-do
decidoj	de-ci-d-oj
decidon	de-ci-d-on
decidos	de-ci-d-os
decidu	de-ci-du
decilitro	de-ci-li-tro
decimetro	de-ci-me-tro
deco	de-co
dediĉas	de-di-ĉ-as
dediĉata	de-di-ĉ-ata
dediĉatan	de-di-ĉ-at-an
dediĉi	de-di-ĉi
dediĉinte	de-di-ĉ-in-te
dediĉis	de-di-ĉ-is
dediĉpaĝo	de-diĉ-pa-ĝo
deduktoj	de-duk-t-oj
defalis	de-fa-l-is
defendantoj	de-fen-d-an-t-oj
defendi	de-fen-di
deficito	de-fi-ci-to
defilo	de-fi-lo
definitiva	de-fi-ni-ti-va
definitivan	de-fi-ni-ti-v-an
deflugi	de-flu-gi
defluilo	de-flu-ilo
degeli	de-ge-li
deiĝi	de-iĝi
deĵori	de-ĵo-ri
dekametro	de-ka-me-tro
dekano	de-ka-no
dekduo	dek-duo
dekduopon	dek-du-op-on
dekjara	dek-jara
dekjaroj	dek-jar-oj
dekkvina	dek-kvina
deklari	de-kla-ri
deklarita	de-kla-r-ita
deklaro	de-kla-ro
deklinacioj	de-kli-na-ci-oj
deklivo	de-kli-vo
dekoj	de-k-oj
dekoka	dek-oka
dekon	de-k-on
dekona	dek-ona
dekonajn	dek-on-ajn
dekonaĵo	dek-on-aĵo
dekonduki	de-kon-du-ki
dekone	dek-one
dekono	dek-ono
dekonojn	dek-on-ojn
dekonon	dek-on-on
dekonsili	de-kon-si-li
dekontrahiĝo	de-kon-tra-h-iĝo
dekopaj	dek-op-aj
dekopajn	dek-op-ajn
dekope	dek-ope
dekopo	dek-opo
dekopojn	dek-op-ojn
dekoracio	de-ko-ra-cio
deksepa	dek-se-pa
dekstra	deks-tra
dekstren	deks-tren
dekunuan	dek-unu-an
delegatoj	de-le-g-at-oj
delegi	de-le-gi
delikata	de-li-ka-ta
deliri	de-liri
delogi	de-lo-gi
delonge	de-longe
demandado	de-man-d-ado
demandante	de-man-d-an-te
demandas	de-man-d-as
demandis	de-man-d-is
demando	de-man-do
demandoj	de-man-d-oj
demandon	de-man-d-on
demeto	de-me-to
demono	de-mo-no
demonstras	de-mons-tr-as
denove	de-no-ve
densa	den-sa
densega	den-sega
dentlipsonoj	dent-lip-so-n-oj
dentdoloro	dent-do-lo-ro
dento	den-to
denunci	de-nun-ci
depago	de-pa-go
departemento	de-par-te-men-to
dependa	de-pen-da
dependas	de-pen-d-as
depende	de-pen-de
dependi	de-pen-di
dependo	de-pen-do
dependus	de-pen-d-us
deponi	de-po-ni
depoto	de-po-to
depozicio	de-po-zi-cio
deprunti	de-prun-ti
deputi	de-pu-ti
derivaĵo	de-ri-v-aĵo
derivaĵoj	de-ri-v-aĵ-oj
deriviĝas	de-ri-v-iĝ-as
derivita	de-ri-v-ita
descendo	de-s-cen-do
desegnaĵoj	de-seg-n-aĵ-oj
desegni	de-seg-ni
desegno	de-seg-no
deserto	de-ser-to
despoto	de-s-po-to
destini	des-ti-ni
destino	des-ti-no
destinon	des-ti-n-on
desube	de-su-be
desupra	de-su-pra
detalaj	de-ta-l-aj
detale	de-ta-le
detalo	de-ta-lo
detalon	de-ta-l-on
detenadus	de-te-n-ad-us
deteni	de-te-ni
determini	de-ter-mi-ni
detrui	de-trui
detruos	de-tru-os
devas	dev-as
devenan	de-ven-an
deveni	de-veni
deveno	de-veno
devi	devi
devigi	dev-igi
devigite	dev-ig-ite
devigus	dev-ig-us
devintus	dev-int-us
devis	dev-is
devkonscia	dev-kon-scia
devo	devo
devojiĝis	de-voj-iĝ-is
devontigi	devon-t-igi
devos	dev-os
devoscia	devo-scia
devoto	devo-to
devus	dev-us
dezerto	de-zer-to
dezirantaj	de-zir-an-t-aj
dezirante	de-zir-an-te
deziras	de-zir-as
deziri	de-ziri
dezirinda	de-zir-inda
dezirindeco	de-zir-ind-eco
deziris	de-zir-is
deziro	de-ziro
deziron	de-zir-on
deziros	de-zir-os
dezirus	de-zir-us
diabeto	di-abe-to
diable	di-ab-le
diablo	di-ab-lo
diademo	di-ade-mo
dialogo	di-alo-go
diamanto	di-am-an-to
dianto	di-an-to
dieto	di-eto
difekti	di-fek-ti
difekto	di-fek-to
diferencas	di-fe-ren-c-as
diferenci	di-fe-ren-ci
diferencigado	di-fe-ren-c-ig-ado
diferencigi	di-fe-ren-c-igi
diferenco	di-fe-ren-co
difini	di-fi-ni
difinis	di-fi-n-is
difinita	di-fi-n-ita
difinitaj	di-fi-n-it-aj
difinitan	di-fi-n-it-an
digesti	di-ges-ti
digito	di-gi-to
digne	digne
dignecon	dig-n-ec-on
digo	di-go
dika	di-ka
dikaj	di-k-aj
dikiĝi	di-k-iĝi
diktaton	dik-t-at-on
dikti	dik-ti
dilemo	di-le-mo
diletanto	di-le-tan-to
diligenta	di-li-gen-ta
dimanĉo	di-man-ĉo
dimensio	di-men-sio
dinamito	di-na-mi-to
dinaro	di-na-ro
dingo	din-go
dioksida	di-ok-si-da
dion	di-on
diplomatiisto	di-plo-ma-ti-isto
diplomatiistoj	di-plo-ma-ti-ist-oj
diplomato	di-plo-ma-to
diradis	dir-ad-is
diranta	dir-an-ta
dirante	dir-an-te
diras	dir-as
direktado	di-rek-t-ado
direktilo	di-rek-t-ilo
direkto	di-rek-to
direktoj	di-rek-t-oj
direktoro	di-rek-to-ro
diri	diri
diris	dir-is
dirita	dir-ita
diritaj	dir-it-aj
diro	diro
diros	dir-os
diru	diru
dirus	dir-us
disa	disa
disajn	dis-ajn
disciplina	dis-ci-pli-na
disciplinema	dis-ci-pli-n-ema
disciplini	dis-ci-pli-ni
dise	dise
disen	dis-en
diserti	di-ser-ti
diservo	di-ser-vo
disigi	dis-igi
disigitaj	dis-ig-it-aj
disiĝi	dis-iĝi
disipi	di-si-pi
disiri	dis-iri
disĵeti	dis-ĵe-ti
disligitaj	dis-lig-it-aj
diskanto	dis-kan-to
disko	dis-ko
diskonto	dis-kon-to
diskreditigis	dis-kre-di-t-ig-is
diskreta	dis-k-reta
diskretaj	dis-k-ret-aj
diskrete	dis-k-rete
diskuras	dis-ku-r-as
diskuri	dis-ku-ri
diskutado	dis-ku-t-ado
diskuti	dis-ku-ti
diskuto	dis-ku-to
diskutoj	dis-ku-t-oj
disocia	di-so-cia
disponeblaj	dis-po-n-eb-l-aj
disponebleco	dis-po-n-eb-l-eco
disponi	dis-po-ni
disponigita	dis-po-n-ig-ita
dispremos	dis-pre-m-os
disputi	dis-pu-ti
disreviĝi	dis-re-v-iĝi
dissemi	dis-semi
dissemitaj	dis-se-m-it-aj
disŝiri	dis-ŝiri
disŝpruci	dis-ŝpru-ci
distanco	dis-tan-co
distilo	dis-ti-lo
distingi	dis-tin-gi
distingiĝa	dis-ting-iĝa
distingiĝas	dis-ting-iĝ-as
distingo	dis-tin-go
distingon	dis-tin-g-on
distri	dis-tri
distribui	dis-tri-bui
disvastigo	dis-va-s-t-igo
disvolviĝadi	dis-vol-v-iĝ-adi
disvolviĝadis	dis-vol-v-iĝ-ad-is
disvolviĝan	dis-vol-v-iĝ-an
disvolviĝos	dis-vol-v-iĝ-os
diveni	di-ve-ni
diversa	di-versa
diversaj	di-vers-aj
diversan	di-vers-an
diversas	di-vers-as
diversaspeca	di-ver-sa-spe-ca
diversaspekta	di-vers-as-pek-ta
diversaspektan	di-vers-as-pek-t-an
diverscela	di-vers-ce-la
diversepoka	di-vers-e-po-ka
diversflanka	di-vers-flan-ka
diversforma	di-vers-for-ma
diversforman	di-vers-for-m-an
diversfunkcia	di-vers-funk-cia
diversgenta	di-vers-gen-ta
diversgrada	di-vers-gra-da
diversgranda	di-vers-granda
diversĝenraj	di-vers-ĝen-r-aj
diverskaraktera	di-vers-ka-rak-te-ra
diverskolora	di-vers-ko-lo-ra
diverskoloraj	di-vers-ko-lo-r-aj
diverskonsista	di-vers-kon-si-s-ta
diverslanda	di-vers-lan-da
diverslarĝa	di-vers-lar-ĝa
diverslingva	di-vers-lin-g-va
diversloka	di-vers-lo-ka
diverslonga	di-vers-longa
diversmaniera	di-vers-ma-ni-e-ra
diversmaniere	di-vers-ma-ni-e-re
diversnacia	di-vers-na-cia
diversnivela	di-vers-ni-ve-la
diverspeca	di-vers-pe-ca
diversprotokolaj	di-vers-pro-to-ko-l-aj
diversrasa	di-vers-ra-sa
diversrilataj	di-vers-ri-la-t-aj
diverssenca	di-vers-sen-ca
diverssignara	di-vers-sig-n-ara
diversspeca	di-vers-spe-ca
diverstema	di-vers-te-ma
diverstipa	di-vers-ti-pa
diversvoja	di-vers-vo-ja
divida	di-vi-da
dividebla	di-vi-d-eb-la
dividi	di-vi-di
dividita	di-vi-d-ita
dividitaj	di-vi-d-it-aj
divido	di-vi-do
dividostreko	di-vi-do-stre-ko
dividpunkto	di-vid-punk-to
dividstreko	di-vid-stre-ko
dogano	do-ga-no
doktoredzino	dok-to-r-edzi-no
doktoro	dok-to-ro
doktoron	dok-to-r-on
dokumento	do-ku-men-to
dokumentoj	do-ku-men-t-oj
dokumenton	do-ku-men-t-on
dolaro	do-la-ro
dolĉa	dol-ĉa
dolĉaĵoj	dol-ĉ-aĵ-oj
dolĉaĵvendejon	dol-ĉaĵ-ven-d-ej-on
dolĉvoĉe	dolĉ-vo-ĉe
dolora	do-lo-ra
doloras	do-lo-r-as
dolore	do-lo-re
doloris	do-lo-r-is
doloro	do-lo-ro
domaĉo	do-m-aĉo
domadministranto?	do-m-ad-mi-ni-s-tr-an-to
domaĝi	do-ma-ĝi
domicilo	do-mi-ci-lo
domingo	do-min-go
domo	do-mo
domoj	do-m-oj
domon	do-m-on
donaco	do-na-co
donadi	do-n-adi
donanto	do-n-an-to
donas	do-n-as
doni	do-ni
doninte	do-n-in-te
donis	do-n-is
donita	do-n-ita
donos	do-n-os
donu	do-nu
donus	do-n-us
dorloti	dor-lo-ti
dorloto	dor-lo-to
dormanta	dorm-an-ta
dormante	dorm-an-te
dormas	dorm-as
dormĉambroj	dorm-ĉam-br-oj
dorme	dorme
dormeti	dorm-eti
dormi	dormi
dormigan	dorm-ig-an
dormigi	dorm-igi
dormis	dorm-is
dormo	dormo
dormoĉambro	dormo-ĉam-bro
dorno	dor-no
dorsflanke	dors-flan-ke
dorso	dor-so
doto	do-to
dozo	do-zo
draĥmojn	draĥ-m-ojn
draman	dra-m-an
dramo	dra-mo
drapo	dra-po
draŝcilindro	draŝ-ci-lin-dro
draŝmaŝino	dra-ŝ-ma-ŝi-no
drato	dra-to
dresi	dre-si
drilo	dri-lo
drinkejo	drin-k-ejo
drogkontrolo	drog-kon-tro-lo
drogo	dro-go
drogon	dro-g-on
droni	dro-ni
drono	dro-no
droŝko	droŝ-ko
duan	du-an
duba	du-ba
dubaj	du-b-aj
dubas	du-b-as
dube	du-be
dubi	du-bi
dubis	du-b-is
dubo	du-bo
duboj	du-b-oj
dubon	du-b-on
dubus	du-b-us
dudek	du-dek
dudeka	du-de-ka
dudirekta	du-di-rek-ta
dufoje	du-foje
duformaj	du-for-m-aj
dukategoria	du-ka-te-go-ria
dukategoriaj	du-ka-te-go-ri-aj
dukato	du-ka-to
duma	duma
dumaon	du-ma-on
dumasta	du-ma-s-ta
dume	dume
dumejla	du-mej-la
dumetra	du-me-tra
dumire	dum-ire
dumonata	du-mo-na-ta
dumpingo	dum-pin-go
dumtempe	dum-tem-pe
dumviva	dum-vi-va
dunaskito	du-na-s-k-ito
dungi	dun-gi
dungosoldato	dun-go-sol-da-to
duobla	du-ob-la
duoblaĵoj	du-ob-l-aĵ-oj
duoblan	du-ob-l-an
duoblo	du-ob-lo
duonebria??	duon-e-bri-a?
duondioj	duon-di-oj
duone	duone
duonfrato	duon-fra-to
duonhoro	duon-ho-ro
duoninformita	duon-in-for-m-ita
duono	duono
duonpatrino	duon-pa-tri-no
duonpatro	duon-pa-tro
duonrido	duon-rido
duonsfero	duon-sfe-ro
duopajn	du-op-ajn
duopan	du-op-an
duope	du-ope
duopo	du-opo
duopoj	du-op-oj
duopojn	du-op-ojn
duopon	du-op-on
dupunkto	du-punk-to
duslupa	du-slu-pa
duspeca	du-spe-ca
duŝo	du-ŝo
ebena	ebe-na
ebeno	ebe-no
ebla	eb-la
eblaj	eb-l-aj
eblaĵo	eb-l-aĵo
eblas	eb-l-as
eble	eb-le
ebleco	eb-l-eco
eblecon	eb-l-ec-on
ebligantaj	eb-l-ig-an-t-aj
ebligas	eb-l-ig-as
ebligi	eb-l-igi
ebligis	eb-l-ig-is
eblo	eb-lo
eblon	eb-l-on
eblus	ebl-us
ebria	ebria
ecoj	ec-oj
econ	ec-on
edemo	ede-mo
edilo	edi-lo
edukados	edu-k-ad-os
eduki	edu-ki
edukita	edu-k-ita
edzeco	edz-eco
edziĝa	edz-iĝa
edziĝfeston	edziĝ-fes-t-on
edziĝi	edz-iĝi
edziĝo	edz-iĝo
edziĝpeton	edziĝ-pet-on
edzinigi	edzi-n-igi
edziniĝi	edzi-n-iĝi
edzino	edzi-no
edzo	edzo
efektiva	efek-ti-va
efektivaj	efek-ti-v-aj
efektive	efek-ti-ve
efektiveco	efek-ti-v-eco
efektivigebla	efek-ti-v-ig-eb-la
efektivigita	efek-ti-v-ig-ita
efektivigo	efek-ti-v-igo
efektiviĝi	efek-ti-v-iĝi
efektiviĝis	efek-ti-v-iĝ-is
efektiviĝon	efek-ti-v-iĝ-on
efektiviĝos	efek-ti-v-iĝ-os
efektiviĝus	efek-ti-v-iĝ-us
efekto	efek-to
efekton	efek-t-on
efiki	efi-ki
efrito	ef-ri-to
egala	ega-la
egalaj	ega-l-aj
egalan	ega-l-an
egale	ega-le
egalpezon	egal-pe-z-on
egido	egi-do
egoismo	ego-ismo
egoisto	ego-isto
eĥoŝanĝo	eĥo-ŝan-ĝo
ejakulo	eja-ku-lo
ejnŝtejna	ejn-ŝtej-na
ekamis	ek-am-is
ekaperas	ek-ape-r-as
ekaperis	ek-ape-r-is
ekbatis	ek-ba-t-is
ekbrilis	ek-bri-l-is
ekbrilo	ek-bri-lo
ekde	ek-de
ekdeziri	ek-de-ziri
ekdeziros	ek-de-zir-os
ekdormis	ek-dorm-is
ekflorado	ek-flo-r-ado
ekfrapi	ek-fra-pi
ekfrapos	ek-fra-p-os
ekfrotaj	ek-fro-t-aj
ekfumis	ek-fum-is
ekĝemis	ek-ĝe-m-is
ekhaltis	ek-hal-t-is
ekhavis	ek-ha-v-is
ekipi	eki-pi
ekiras	ek-ir-as
ekirigas	ek-ir-ig-as
ekkanti	ek-kan-ti
ekknari	ek-kna-ri
ekkolerema	ek-ko-le-r-ema
ekkrii	ek-krii
eklamas	ek-lam-as
eklezio	ek-le-zio
eklumas	ek-lum-as
êklidaj	êkli-d-aj
ekmalamis	ek-mal-am-is
ekmalĝojis	ek-mal-ĝoj-is
ekmemoru	ek-me-mo-ru
ekologio	eko-lo-gio
ekonomio	eko-no-mio
ekonomioj	eko-no-mi-oj
ekonomion	eko-no-mi-on
ekparoli	ek-pa-roli
ekpaŝas	ek-pa-ŝ-as
ekpensi	ek-pen-si
ekpensis	ek-pen-sis
ekpensos	ek-pen-sos
ekpensu	ek-pen-su
ekpensus	ek-pen-sus
ekposedas	ek-po-se-d-as
ekposedi	ek-po-se-di
ekposedis	ek-po-se-d-is
ekposedo	ek-po-se-do
ekpovu	ek-po-vu
ekpremo	ek-pre-mo
ekrano	ek-ra-no
ekregis	ek-re-g-is
ekridis	ek-ri-d-is
ekridus	ek-ri-d-us
ekrigardi	ek-ri-gar-di
ekrigardis	ek-ri-gar-d-is
eksalti	ek-sal-ti
ekscentra	eks-cen-tra
ekscii	ek-scii
eksciis	ek-sci-is
ekscios	ek-sci-os
eksciti	ek-s-ci-ti
ekscitiĝi	ek-s-ci-t-iĝi
ekscitmaŝino	ek-s-cit-ma-ŝi-no
eksciz	eks-ciz
eksekvis	ek-se-k-v-is
eksentis	ek-sen-t-is
eksĝustiĝi	eks-ĝu-s-t-iĝi
eksidis	ek-si-d-is
eksidu	ek-si-du
eksigata	eks-ig-ata
ekskluzive	eks-klu-zi-ve
ekskui	ek-skui
ekskursi	eks-kur-si
ekskuzi	eks-ku-zi
eksmodaj	eks-mo-d-aj
eksnobelo	eks-no-be-lo
eksnufi	ek-snu-fi
eksonados	ek-so-n-ad-os
ekspedi	eks-pe-di
eksperimento	eks-pe-ri-men-to
eksplicito	eks-pli-ci-to
eksplodi	eks-plo-di
eksplodigi	eks-plo-d-igi
eksplodis	eks-plo-d-is
eksplodkesto	eks-plod-kes-to
ekspluati	eks-plu-a-ti
eksporti	eks-por-ti
ekspozicio	eks-po-zi-cio
ekstaras	ek-sta-r-as
ekstaros	ek-sta-r-os
ekster	eks-ter
ekstera	eks-tera
eksterajn	eks-ter-ajn
eksteran	eks-ter-an
ekstere	eks-tere
eksteren	eks-ter-en
ekstero	eks-tero
eksterordinara	eks-ter-or-di-na-ra
eksteros	eks-ter-os
eksterus	eks-ter-us
ekstra	eks-tra
ekstrema	eks-tre-ma
ekstremo	eks-tre-mo
ekŝpruci	ek-ŝpru-ci
ekŝvelis	ek-ŝve-l-is
ekŝvita	ek-ŝvi-ta
ektimis	ek-ti-m-is
ektimos	ek-ti-m-os
ektremo	ek-tre-mo
ekturnis	ek-tur-n-is
ekvatoro	ek-va-to-ro
ekvidis	ek-vi-d-is
ekvidos	ek-vi-d-os
ekvidus	ek-vi-d-us
ekvilibro	ek-vi-li-bro
ekvolos	ek-vo-l-os
ekzakta	ek-zak-ta
ekzameni	ek-za-me-ni
ekzekuti	ek-ze-ku-ti
ekzemo	ek-ze-mo
ekzemple	ek-zem-ple
ekzemplo	ek-zem-plo
ekzemploj	ek-zem-pl-oj
ekzemplon	ek-zem-pl-on
ekzercadi	ek-zer-c-adi
ekzercaro	ek-zer-c-aro
ekzerci	ek-zer-ci
ekzerciĝadi	ek-zer-c-iĝ-adi
ekzerciĝadon	ek-zer-c-iĝ-ad-on
ekzercoj	ek-zer-c-oj
ekzilo	ek-zi-lo
ekzistado	ek-zi-s-t-ado
ekzistadon	ek-zi-s-t-ad-on
ekzistaĵo	ek-zi-s-t-aĵo
ekzistaĵoj	ek-zi-s-t-aĵ-oj
ekzistanta	ek-zi-s-t-an-ta
ekzistantaj	ek-zi-s-t-an-t-aj
ekzistantan	ek-zi-s-t-an-t-an
ekzistas	ek-zi-s-t-as
ekzisti	ek-zi-s-ti
ekzistis	ek-zi-s-t-is
ekziston	ek-zi-s-t-on
ekzistus	ek-zi-s-t-us
ekzoto	ek-zo-to
elaĉeto	el-aĉe-to
elano	ela-no
elasta	ela-s-ta
elaŭskulti	elaŭ-s-kul-ti
elbakitaj	el-ba-k-it-aj
eldoni	el-do-ni
eldonis	el-do-n-is
eldono	el-do-no
elefanto	ele-fan-to
eleganta	ele-gan-ta
elektantoj	elek-t-an-t-oj
elektas	elek-t-as
elekti	elek-ti
elektis	elek-t-is
elektita	elek-t-ita
elektitaj	elek-t-it-aj
elekto	elek-to
elekton	elek-t-on
elektos	elek-t-os
elektro	elek-tro
elektrofono	elek-tro-fo-no
elektronikaj	elek-tro-ni-k-aj
elektroniko	elek-tro-ni-ko
elektus	elek-t-us
elementa	ele-menta
elementanalizo	ele-ment-ana-li-zo
elemento	ele-mento
elementoj	ele-ment-oj
elfalas	el-fa-l-as
elfali	el-fa-li
elfaritaj	el-fa-r-it-aj
elfknabinoj	elf-kna-bi-n-oj
elfluas	el-flu-as
eligi	eligi
eliminado	eli-mi-n-ado
eliminadon	eli-mi-n-ad-on
elimini	eli-mi-ni
eliminis	eli-mi-n-is
eliminitaj	eli-mi-n-it-aj
elirante	el-ir-an-te
eliras	el-ir-as
eliri	el-iri
eliris	el-ir-is
eliros	el-ir-os
elita	eli-ta
elito	eli-to
elizabeto	eli-za-be-to
eliziita	eli-zi-ita
elĵeti	el-ĵe-ti
elĵetita	el-ĵe-t-ita
elĵetitaj	el-ĵe-t-it-aj
elkreskadas	el-kre-s-k-ad-as
ellaboradi	el-la-bo-r-adi
ellabori	el-la-bo-ri
ellaborita	el-la-bo-r-ita
ellaborota	el-la-bo-ro-ta
ellernadi	el-ler-n-adi
ellernado	el-ler-n-ado
ellernadon	el-ler-n-ad-on
ellernadu	el-ler-n-adu
ellernadus	el-ler-n-ad-us
ellernas	el-ler-n-as
ellernata	el-ler-n-ata
ellerni	el-ler-ni
ellerninte	el-ler-n-in-te
ellernis	el-ler-n-is
ellernita	el-ler-n-ita
ellerno	el-ler-no
ellitiĝis	el-li-t-iĝ-is
elmansanulejiĝos	el-man-sa-n-ul-ej-iĝ-os
elmetas	el-met-as
elmeti	el-meti
elmetita	el-me-t-ita
elmetu	el-metu
elparolado	el-pa-rol-ado
elparoladon	el-pa-rol-ad-on
elparolados	el-pa-rol-ad-os
elparolata	el-pa-rol-ata
elparoli	el-pa-roli
elparolitan	el-pa-rol-i-t-an
elpaŝadis	el-pa-ŝ-ad-is
elpendaĵo	el-pen-d-aĵo
elpensi	el-pen-si
elpensintaj	el-pen-sin-t-aj
elpensinto	el-pen-sin-to
elpensis	el-pen-sis
elpensitaj	el-pen-sit-aj
elpensiteco	el-pen-sit-eco
elpenso	el-pen-so
elpensoj	el-pen-soj
elportas	el-por-t-as
elportebla	el-por-t-eb-la
elporti	el-por-ti
elpremis	el-pre-m-is
elprenas	el-pre-n-as
elprenita	el-pre-n-ita
elprovita	el-pro-v-ita
elprovitan	el-pro-v-it-an
elpuŝis	el-pu-ŝ-is
elpuŝita	el-pu-ŝ-ita
elpuŝus	el-pu-ŝ-us
elrampi	el-ram-pi
elsalti	el-sal-ti
elskatole	el-ska-to-le
elspezi	el-spe-zi
elstarajn	el-sta-r-ajn
elŝpruci	el-ŝpru-ci
elŝveli	el-ŝve-li
eltiraĵo	el-tir-aĵo
eltiras	el-tir-as
eltiris	el-tir-is
eltiritaj	el-tir-it-aj
eltrovi	el-tro-vi
eltrovitan	el-tro-v-it-an
eltrovo	el-tro-vo
elturniĝi	el-tur-n-iĝi
eluzi	el-uzi
elveni	el-ve-ni
elvokos	el-vo-k-os
elvringon	el-vrin-g-on
emajlo	emaj-lo
emas	em-as
embaraso	em-ba-ra-so
emblemoj	em-ble-m-oj
emerito	eme-ri-to
emfizemo	em-fi-ze-mo
eminenta	emi-nen-ta
eminentaj	emi-nen-t-aj
eminjo	emi-njo
emocio	emo-cio
emon	em-on
emulsio	emul-sio
enamiĝus	ena-m-iĝ-us
endormiĝadus	en-dorm-iĝ-ad-us
energiaj	ener-gi-aj
energio	ener-gio
energion	ener-gi-on
energiŝpara	ener-gi-ŝpara
enestas	en-es-t-as
enestis	en-es-t-is
enfali	en-fa-li
englutas	en-glu-t-as
englutis	en-glu-t-is
engluton	en-glu-t-on
englutos	en-glu-t-os
enhavas	en-ha-v-as
enhavi	en-ha-vi
enhavo	en-ha-vo
enhavon	en-ha-v-on
enigmo	enig-mo
eniĝadi	en-iĝ-adi
eniĝi	en-iĝi
eniras	en-ir-as
eniri	en-iri
eniris	en-ir-is
eniros	en-ir-os
enirpaĝo	en-ir-pa-ĝo
eniru	en-iru
enketi	en-ke-ti
enketis	en-ke-t-is
enketo	en-ke-to
enketoj	en-ke-t-oj
enkondukas	en-kon-du-k-as
enkondukita	en-kon-du-k-ita
enkonduko	en-kon-du-ko
enkondukon	en-kon-du-k-on
enkondukos	en-kon-du-k-os
enlasi	en-la-si
enmalsanulejigi	en-mal-sa-n-ul-ej-igi
enman	en-m-an
enmane	en-mane
enmetas	en-met-as
enmetis	en-met-is
enmetita	en-me-t-ita
enmiksi	en-mik-si
enmiksiĝi	en-mik-s-iĝi
enmiksiĝis	en-mik-s-iĝ-is
enmiksiĝo	en-mik-s-iĝo
enmiksis	en-mik-s-is
enpensiĝadis	en-pen-siĝ-ad-is
enpensiĝi	en-pen-siĝi
enpensiĝis	en-pen-siĝ-is
enpreni	en-pre-ni
enprenitaj	en-pre-n-it-aj
enpreno	en-pre-no
enprenu	en-pre-nu
enprofundiĝis	en-pro-fun-d-iĝ-is
ensaluti	en-sa-lu-ti
enspezi	en-spe-zi
enŝlosis	en-ŝlo-s-is
enŝlosita	en-ŝlo-s-ita
enŝpruci	en-ŝpru-ci
enŝvebi	en-ŝve-bi
entenas	en-te-n-as
entenu	en-te-nu
enterigi	en-te-r-igi
enterigita	en-te-r-ig-ita
entreprenanto	en-tre-pre-n-an-to
entreprenas	en-tre-pre-n-as
entrepreni	en-tre-pre-ni
entreprenis	en-tre-pre-n-is
entreprenita	en-tre-pre-n-ita
entreprenitaj	en-tre-pre-n-it-aj
entrepreno	en-tre-pre-no
entreprenoj	en-tre-pre-n-oj
entreprenus	en-tre-pre-n-us
entute	en-tu-te
entuziasmo	en-tuzi-asmo
enuan	enu-an
enui	enui
envenas	en-ve-n-as
envenis	en-ve-n-is
envenon	en-ve-n-on
envenus	en-ve-n-us
enveturi	en-ve-tu-ri
envii	en-vii
envio	en-vio
envion	en-vi-on
epidemia	epi-de-mia
epidemio	epi-de-mio
epilogo	epi-lo-go
episkopo	epi-s-ko-po
epiteto	epi-te-to
epizootio	epi-zoo-tio
epoko	epo-ko
epokoj	epo-k-oj
epsilo	ep-si-lo
erara	era-ra
erare	era-re
erari	era-ri
eraroj	era-r-oj
eraron	era-r-on
erarpaŝon	erar-pa-ŝ-on
erĉjo	er-ĉjo
ergoto	er-go-to
ermito	er-mi-to
erneĉjo	er-ne-ĉjo
eroto	ero-to
erudito	eru-di-to
erupciojn	erup-ci-ojn
escepte	es-cep-te
escepti	es-cep-ti
esceptita	es-cep-t-ita
escepton	es-cep-t-on
esceptos	es-cep-t-os
esenca	esen-ca
esence	esen-ce
esenco	esen-co
esencon	esen-c-on
eskapi	es-ka-pi
esperanta	es-pe-r-an-ta
esperantaj	es-pe-r-an-t-aj
esperantan	es-pe-r-an-t-an
esperante	es-pe-r-an-te
esperantista	es-pe-ran-t-ista
esperantisto	es-pe-ran-t-isto
esperantistoj	es-pe-ran-t-ist-oj
esperanto	es-pe-r-an-to
esperantologio	es-pe-ran-to-lo-gio
esperanton	es-pe-r-an-t-on
esperas	es-pe-r-as
espere	es-pe-re
esperi	es-pe-ri
esperis	es-pe-r-is
espero	es-pe-ro
esploranto	es-plo-r-an-to
esplorantoj	es-plo-r-an-t-oj
esploras	es-plo-r-as
esplori	es-plo-ri
esploris	es-plo-r-is
esplorita	es-plo-r-ita
esploro	es-plo-ro
esploroj	es-plo-r-oj
esploron	es-plo-r-on
esprimadi	es-pri-m-adi
esprimado	es-pri-m-ado
esprimante	es-pri-m-an-te
esprimas	es-pri-m-as
esprimataj	es-pri-m-at-aj
esprimi	es-pri-mi
esprimis	es-pri-m-is
esprimitaj	es-pri-mi-t-aj
esprimmanieroj	es-prim-ma-ni-e-r-oj
esprimo	es-pri-mo
esprimoj	es-pri-m-oj
esprimon	es-pri-m-on
esprimos	es-pri-m-os
establado	es-ta-b-l-ado
establi	es-ta-b-li
establis	es-ta-b-l-is
estanta	es-t-an-ta
estas	es-t-as
estetiko	es-te-ti-ko
esti	es-ti
estigi	es-t-igi
estigitan	es-t-ig-it-an
estiĝas	es-t-iĝ-as
estimata	es-ti-m-ata
estimataj	es-ti-m-at-aj
estimi	es-ti-mi
estimo	es-ti-mo
estingi	es-tin-gi
estingo	es-tin-go
estinta	es-t-in-ta
estis	es-t-is
estonta	es-t-onta
estontaj	es-t-ont-aj
estontajn	es-t-ont-ajn
estontaĵo	es-ton-t-aĵo
estontan	es-t-ont-an
estonte	es-t-onte
estonteco	es-ton-t-eco
estontecon	es-ton-t-ec-on
estontoj	es-t-ont-oj
estontojn	es-t-ont-ojn
estonton	es-t-ont-on
estos	es-t-os
estraro	es-tr-aro
estro	es-tro
estu	es-tu
estus	es-t-us
etaĝo	eta-ĝo
etan	et-an
etapo	eta-po
etato	eta-to
etendi	eten-di
eterna	eter-na
eterne	eterne
etilo	eti-lo
etŝpura	et-ŝpu-ra
etulino	et-ul-ino
eŭklido	eŭ-kli-do
eŭropa	eŭ-ro-pa
eŭropaj	eŭ-ro-p-aj
eŭropanoj	eŭ-ro-pa-n-oj
eŭropo	eŭ-ro-po
evento	even-to
eventuala	even-tu-a-la
eventualaj	even-tu-a-l-aj
evidenta	evi-den-ta
evidentan	evi-den-t-an
evidente	evi-den-te
evidentiĝos	evi-den-t-iĝ-os
eviti	evi-ti
evito	evi-to
evitu	evi-tu
evolui	evo-lui
ezoko	ezo-ko
fabelo	fa-be-lo
fabo	fa-bo
fabriko	fab-ri-ko
faceto	fa-c-eto
facila	fa-ci-la
facilan	fa-ci-l-an
facile	fa-ci-le
facileco	fa-ci-l-eco
facilecon	fa-ci-l-ec-on
faciligo	fa-ci-l-igo
faciligoj	fa-ci-l-ig-oj
faciligon	fa-ci-l-ig-on
faciligos	fa-ci-l-ig-os
faco	fa-co
fadeno	fa-de-no
fago	fa-go
fagoto	fa-go-to
fajenco	fa-jen-co
fajfi	faj-fi
fajfilo	faj-f-ilo
fajrero	faj-re-ro
fajro	faj-ro
fakaj	fa-k-aj
fakgazeto	fak-ga-z-eto
fakgrupo	fak-gru-po
fakĵargono	fak-ĵar-go-no
fako	fa-ko
faktan	fak-t-an
fakte	fak-te
fakto	fak-to
faktoj	fak-t-oj
fakton	fak-t-on
faktoto	fak-to-to
fakulo	fa-k-ulo
fakultatoj	fa-kul-ta-t-oj
falas	fa-l-as
falĉi	fal-ĉi
falĉilo	fal-ĉ-ilo
faleti	fa-l-eti
fali	fa-li
faligi	fa-ligi
falis	fa-l-is
falsa	falsa
falsafiksajn	fals-a-fik-s-ajn
falsaj	fals-aj
falsan	fals-an
falseto	fal-se-to
falsetulo	fal-se-t-ulo
falsidas	fal-si-d-as
falsĵuro	fals-ĵu-ro
falslanga	fals-lan-ga
falstelo	fal-ste-lo
falus	fa-l-us
fama	fa-ma
familia	fa-mi-lia
familiara	fa-mi-li-ara
familio	fa-mi-lio
famoj	fa-m-oj
fandi	fan-di
fandodrato	fan-do-dra-to
fanfaronante	fan-fa-ro-n-an-te
fanfaroni	fan-fa-ro-ni
fantazian	fan-ta-zi-an
fantaziistoj	fan-ta-zi-ist-oj
fantazio	fan-ta-zio
fantazion	fan-ta-zi-on
fantaziuloj	fan-ta-zi-ul-oj
fantomino	fan-to-mi-no
fantomo	fan-to-mo
fantomoj	fan-to-m-oj
faradi	fa-r-adi
faradis	fa-r-ad-is
faras	fa-r-as
farataj	fa-r-at-aj
farbo	far-bo
farebla	fa-r-eb-la
fari	fa-ri
fariĝados	fa-r-iĝ-ad-os
fariĝas	fa-r-iĝ-as
fariĝi	fa-r-iĝi
fariĝis	fa-r-iĝ-is
fariĝos	fa-r-iĝ-os
fariĝus	fa-r-iĝ-us
faringo	fa-rin-go
farino	fa-ri-no
farinta	fa-r-in-ta
faris	fa-r-is
farita	fa-r-ita
faritaj	fa-r-it-aj
farmi	far-mi
faros	fa-r-os
farti	far-ti
fartis	far-t-is
faru	fa-ru
faruno	fa-ru-no
farus	fa-r-us
fasado	fa-sa-do
fascini	fa-sci-ni
fasko	fa-s-ko
fasono	fa-so-no
fasti	fa-s-ti
faŭko	faŭ-ko
favora	fa-vo-ra
favorkoruloj	fa-vor-ko-r-ul-oj
fazano	fa-za-no
fazeolo	fa-ze-o-lo
febla	fe-b-la
febro	fe-bro
februaro	fe-bru-aro
feĉo	fe-ĉo
federacio	fe-de-ra-cio
feino	fe-i-no
feliĉa	fe-li-ĉa
feliĉe	fe-li-ĉe
feliĉigi	fe-li-ĉ-igi
feliĉvizaĝa	fe-liĉ-vi-zaĝa
felietonisto	fe-li-e-to-n-isto
felo	fe-lo
felto	fel-to
fendo	fen-do
fenestro	fe-ne-s-t-ro
fenestrokovriloj	fe-ne-s-t-ro-kov-ril-oj
fenestron	fe-ne-s-t-r-on
fenomeno	fe-no-me-no
ferio	fe-rio
fermadis	ferm-ad-is
fermi	fermi
fermiĝis	ferm-iĝ-is
fermitaj	ferm-it-aj
fero	fe-ro
feron	fe-r-on
fervojo	fer-vo-jo
fervojoj	fer-vo-j-oj
fervora	fer-vo-ra
fervoraj	fer-vo-r-aj
fervoreco	fer-vo-r-eco
fervoro	fer-vo-ro
festĉambrego	fest-ĉam-bre-go
festeni	fes-te-ni
festi	fes-ti
fiakro	fi-akro
fianĉiĝi	fi-an-ĉ-iĝi
fianĉino	fi-an-ĉi-no
fianĉo	fi-an-ĉo
fiasko	fi-asko
fidas	fi-d-as
fidela	fi-de-la
fidi	fi-di
fidinda	fi-d-inda
fido	fido
fiera	fi-e-ra
fieraj	fi-e-r-aj
figarbo	fig-arbo
figĝardeno	fig-ĝar-de-no
figo	fi-go
figu	fi-gu
figuro	fi-gu-ro
fikcio	fik-cio
fiksado	fiks-ado
fiksangulo	fiks-an-gu-lo
fiksas	fiks-as
fiksi	fiksi
fiksideulo	fiks-ide-ulo
fikskomo	fiks-ko-mo
fikslarĝa	fiks-lar-ĝa
fikspunkta	fiks-punk-ta
fiksrigardi	fiks-ri-gar-di
filario	fi-la-rio
filatelisto	fi-la-te-l-isto
filino	fi-li-no
filinon	fi-li-n-on
filmo	fil-mo
filo	fi-lo
filoj	fi-l-oj
filozofadi	fi-lo-zo-f-adi
filozofia	fi-lo-zo-fia
filozofio	fi-lo-zo-fio
filozofo	fi-lo-zo-fo
fina	fi-na
finaĵo	fi-n-aĵo
finaĵoj	fi-n-aĵ-oj
financaj	fi-nan-c-aj
financo	fi-nan-co
finanta	fi-n-an-ta
fine	fine
finfine	fin-fine
fingretoj	fin-gret-oj
fingro	fin-gro
fingroj	fin-gr-oj
fini	fi-ni
finiĝadi	fi-n-iĝ-adi
finiĝadis	fi-n-iĝ-ad-is
finiĝas	fi-n-iĝ-as
finiĝi	fi-n-iĝi
finiĝis	fi-n-iĝ-is
finiĝo	fi-n-iĝo
finiĝoj	fi-n-iĝ-oj
finis	fi-n-is
finita	fi-n-ita
finitan	fi-n-it-an
finno	fin-no
fino	fi-no
finos	fi-n-os
finto	fin-to
firma	fir-ma
firman	fir-m-an
firmo	fir-mo
fistulo	fi-s-tu-lo
fiŝhoko	fiŝ-ho-ko
fiŝkaptisto	fiŝ-kap-t-isto
fiŝo	fiŝo
fiŝoleo	fiŝ-oleo
fiŝviando	fiŝ-vi-an-do
fiŝvosto	fiŝ-vo-s-to
Fitzgerald	fitz-ge-rald
fizikisto	fi-zi-k-isto
fiziko	fi-zi-ko
fiziologiaj	fi-zio-lo-gi-aj
flago	fla-go
flagri	fla-gri
flamĵetantaj	flam-ĵe-t-an-t-aj
flamo	fla-mo
flankaj	flan-k-aj
flankaparato	flan-k-apa-ra-to
flanke	flan-ke
flanken	flan-ken
flankkurteno	flank-kur-te-no
flanko	flan-ko
flankoj	flan-k-oj
flankon	flan-k-on
flari	fla-ri
flatakiri	fla-t-akiri
flata	flata
flati	fla-ti
flava	fla-va
flavharaj	flav-har-aj
flegi	fle-gi
flegistajn	fle-g-ist-ajn
flegiste	fle-g-iste
flegistina	fle-g-ist-ina
flegistinaj	fle-g-ist-in-aj
flegistinajn	fle-g-ist-in-ajn
flegistinan	fle-g-ist-in-an
flegistine	fle-g-ist-ine
flegistino	fle-g-ist-ino
flegistinoj	fle-g-ist-in-oj
flegistinojn	fle-g-ist-in-ojn
flegistinon	fle-g-ist-in-on
flegistojn	fle-g-ist-ojn
flego	fle-go
fleksebla	flek-s-eb-la
fleksebleco	flek-s-eb-l-eco
flekseblecon	flek-s-eb-l-ec-on
fleksi	flek-si
fleksloko	fleks-lo-ko
fliki	fli-ki
flirti	flir-ti
floraranĝo?	flo-r-aran-ĝo
floras	flo-r-as
flori	flo-ri
florido	flo-ri-do
floro	flo-ro
florpoto	flor-po-to
flosligno	flos-lig-no
floslinio	flos-li-nio
floso	flo-so
floto	flo-to
flue	flue
flugado	flu-g-ado
flughaveno	flug-ha-ve-no
flugi	flu-gi
flugilo	flu-g-ilo
flugis	flu-g-is
flugos	flu-g-os
flugpendantaj	flug-pen-d-an-t-aj
flugsciuro	flug-sci-uro
flugu	flu-gu
flui	flui
fluidaĵo	flu-i-d-aĵo
fluidiĝi	flu-i-d-iĝi
fluido	flu-ido
flustri	flu-s-tri
foiro	fo-iro
foje	foje
fojno	foj-no
fojo	fojo
fojoj	foj-oj
fojon	foj-on
fokstroto	foks-tro-to
foliaranĝo	fo-li-aran-ĝo
folietoj	fo-li-et-oj
folio	fo-lio
fonda	fon-da
fonde	fon-de
fondi	fon-di
fondita	fon-d-ita
fonditaj	fon-d-it-aj
fonditan	fon-d-it-an
fonemo	fo-ne-mo
fonografo	fo-no-gra-fo
fontano	fon-ta-no
fonto	fon-to
fora	fora
foraj	for-aj
forblovi	for-blo-vi
fordonas	for-do-n-as
fore	fore
foren	for-en
foresti	for-es-ti
forflugi	for-flu-gi
forgesas	for-ge-s-as
forgesi	for-ge-si
forgesis	for-ge-s-is
forgesos	for-ge-s-os
forgesu	for-ge-su
forĝi	for-ĝi
fori	fori
forigi	for-igi
forinto	fo-rin-to
foriras	for-ir-as
foriri	for-iri
foririntaj	for-ir-in-t-aj
foriris	for-ir-is
foriros	for-ir-os
foriru	for-iru
forĵetis	for-ĵe-t-is
forĵetu	for-ĵe-tu
forko	for-ko
forkonduki	for-kon-du-ki
forkuras	for-ku-r-as
forkuri	for-ku-ri
forkuris	for-ku-r-is
forkuru	for-ku-ru
forlasita	for-la-s-ita
forlasitan	for-la-s-it-an
forlasos	for-la-s-os
formas	for-m-as
formato	for-ma-to
formeto	for-me-to
formi	for-mi
formiko	for-mi-ko
formo	for-mo
formoj	for-m-oj
formon	for-m-on
formularo	for-mu-la-ro
formulo	for-mu-lo
fornelo	for-ne-lo
forno	for-no
foro	foro
forojn	for-ojn
foron	for-on
foros	for-os
forpeli	for-pe-li
forpermesi	for-per-me-si
forporti	for-por-ti
forportis	for-por-t-is
forpreni	for-pre-ni
forprenis	for-pre-n-is
forprenu	for-pre-nu
forsmirgi	for-smir-gi
forstreki	for-stre-ki
forsvenis	for-sve-n-is
forŝvebis	for-ŝve-b-is
forta	for-ta
fortakvo?	for-t-ak-vo
fortan	for-t-an
forte	for-te
fortepiano	for-te-pi-ano
fortepianon	for-te-pi-an-on
fortigado	for-t-ig-ado
fortiĝinta	for-t-iĝ-in-ta
fortiĝintaj	for-t-iĝ-in-t-aj
fortika	for-ti-ka
fortikaj	for-ti-k-aj
fortikaĵo	for-ti-k-aĵo
fortikiĝus	for-ti-k-iĝ-us
forto	for-to
fortoj	for-t-oj
forton	for-t-on
fortulo	for-t-ulo
forturni	for-tur-ni
forturnis	for-tur-n-is
forumo	fo-ru-mo
foruzita	for-uz-ita
forveturas	for-ve-tu-r-as
forveturos	for-ve-tu-r-os
fosilo	fo-s-ilo
fosto	fo-s-to
fotelo	fo-te-lo
foto	fo-to
fotografaĵo	fo-to-gra-f-aĵo
fotografi	fo-to-gra-fi
fotografisto	fo-to-gra-f-isto
fotokopii	fo-to-ko-pii
fotokopio	fo-to-ko-pio
fotokopion	fo-to-ko-pi-on
fragila	fra-g-ila
frago	fra-go
frakasi	fra-ka-si
frako	fra-ko
frambkolora	framb-ko-lo-ra
frambo	fram-bo
franca	fran-ca
français	fra-nça-is
francaj	fran-c-aj
franclingvaj	franc-lin-g-v-aj
franco	fran-co
frandaĵo	fran-d-aĵo
frandi	fran-di
franko	fran-ko
frapado	fra-p-ado
frapados	fra-p-ad-os
frapante	fra-p-an-te
frapi	fra-pi
frataro	fra-t-aro
fratecon	fra-t-ec-on
fratino	fra-ti-no
frato	fra-to
fraŭla	fraŭ-la
fraŭlino	fraŭ-li-no
fraŭlo	fraŭ-lo
frazaranĝo	fraz-aran-ĝo
frazelemento	fraz-ele-mento
frazeologio	fra-zeo-lo-gio
frazistan	fraz-ist-an
frazistoj	fraz-ist-oj
frazo	frazo
frazoj	fraz-oj
frazon	fraz-on
frekventi	fre-k-ven-ti
fremda	frem-da
fremdaj	frem-d-aj
fremdaĵoj	frem-d-aĵ-oj
fremdan	frem-d-an
fremdlandano	fremd-lan-da-no
fremdlingva	fremd-lin-g-va
fremdulo	frem-d-ulo
freneza	fre-ne-za
frenezaj	fre-ne-z-aj
frenezuloj	fre-ne-z-ul-oj
freŝa	freŝa
freŝdataj	freŝ-dat-aj
freŝgrado	freŝ-gra-do
freŝvianda	freŝ-vi-an-da
freŝvoĉa	freŝ-vo-ĉa
frida	fri-da
frigido	fri-gi-do
fringo	frin-go
fripono	fri-po-no
friti	fri-ti
fritilario	fri-ti-la-rio
frito	fri-to
frizi	fri-zi
fromaĝo	fro-ma-ĝo
frontita	fron-t-ita
fronto	fron-to
frosta	fro-s-ta
frostas	fro-s-t-as
frosto	fro-s-to
frotado	fro-t-ado
froti	fro-ti
froto	fro-to
frua	frua
fruaj	fru-aj
frue	frue
fruktaĵo	fruk-t-aĵo
fruktĝardeno	frukt-ĝar-de-no
frukto	fruk-to
fruktoj	fruk-t-oj
frukton	fruk-t-on
fruktoscienco	fruk-to-sci-en-co
frunto	frun-to
fuĝi	fu-ĝi
fulgo	ful-go
fulmo	ful-mo
fulo	fu-lo
fumo	fu-mo
funda	fun-da
fundamenta	fun-da-men-ta
fundamentaj	fun-da-men-t-aj
fundamentecon	fun-da-men-t-ec-on
fundamento	fun-da-men-to
fundamentoj	fun-da-men-t-oj
fundamenton	fun-da-men-t-on
fundo	fun-do
funebro	fu-ne-bro
funelo	fu-ne-lo
fungo	fun-go
fungoj	fun-g-oj
funkcias	funk-ci-as
funkcio	funk-cio
funkcioj	funk-ci-oj
funkcion	funk-ci-on
funto	fun-to
furaĝo	fu-ra-ĝo
furioza	fu-ri-o-za
furiozaj	fu-ri-o-z-aj
furioze	fu-ri-o-ze
fusilo	fu-si-lo
fuŝa	fuŝa
fuŝe	fuŝe
fuŝemaj	fuŝ-em-aj
fuŝi	fuŝi
fuŝis	fuŝ-is
fuŝita	fuŝ-ita
fuŝpalpi	fuŝ-pal-pi
fuŝparoli	fuŝ-pa-roli
gaja	ga-ja
gajhumora	gaj-hu-mo-ra
gajni	gaj-ni
gajnus	gaj-n-us
gajvizaĝajn	gaj-vi-zaĝ-ajn
galantino	ga-lan-ti-no
galanto	ga-lan-to
galinulo	ga-li-nu-lo
galo	ga-lo
galoŝfabrikistoj	ga-loŝ-fab-ri-k-ist-oj
galoŝo	ga-lo-ŝo
galvano	gal-va-no
gambito	gam-bi-to
ganto	gan-to
garaĝo	ga-ra-ĝo
garantiaĵo	ga-ran-ti-aĵo
garantias	ga-ran-ti-as
garantii	ga-ran-tii
garantiulo	ga-ran-ti-ulo
garbo	garbo
gardanto	gar-d-an-to
gardas	gar-d-as
gardi	gar-di
gardis	gar-d-is
gardos	gar-d-os
gardostaris	gar-do-sta-r-is
gardostaro	gar-do-sta-ro
gargaro	gar-ga-ro
garni	gar-ni
gasakvo?	ga-s-ak-vo
gaso	ga-so
gasrezervujo	gas-re-zer-v-ujo
gasto	ga-s-to
gavoto	ga-vo-to
gazeta	ga-ze-ta
gazeto	ga-ze-to
gazetoj	ga-ze-t-oj
geedzoj	ge-edz-oj
gefianĉoj	ge-fi-an-ĉ-oj
gefratoj	ge-fra-t-oj
gejunuloj	ge-jun-ul-oj
gejŝejo	gej-ŝ-ejo
geknaboj	ge-kna-b-oj
gela	ge-la
gelateno	ge-la-te-no
gelo	ge-lo
gemastroj	ge-ma-s-tr-oj
generacio	ge-ne-ra-cio
generacioj	ge-ne-ra-ci-oj
generalo	ge-ne-ra-lo
genio	ge-nio
genisto	ge-ni-s-to
genocido	ge-no-ci-do
genro	gen-ro
gento	gen-to
genuo	ge-nuo
geografio	geo-gra-fio
gepatra	ge-pa-tra
gepatroj	ge-pa-tr-oj
gerda	ger-da
gerdan	ger-d-an
germana	ger-ma-na
germanaj	ger-ma-n-aj
germanan	ger-ma-n-an
germano	ger-ma-no
germanujo	ger-ma-n-ujo
gesinjoroj	ge-sin-jor-oj
gesti	ges-ti
gestudentoj	ge-stu-den-t-oj
giganto	gigan-to
gimnastikaj	gim-na-s-ti-k-aj
gimnazioj	gim-na-zi-oj
girlando	gir-lan-do
gisto	gi-s-to
gitaro	gi-ta-ro
glaciaĵo	gla-ci-aĵo
glaciigi	gla-ci-igi
glacio	gla-cio
gladi	gladi
glasa	gla-sa
glaseto	gla-s-eto
glaso	gla-so
glasoj	gla-s-oj
glason	gla-s-on
glasrando	glas-ran-do
glata	gla-ta
glavdenta	glav-den-ta
glavo	gla-vo
gliti	gli-ti
glitilo	gli-t-ilo
glito	gli-to
glitveturilo	glit-ve-tu-r-ilo
globforma	glob-for-ma
globo	glo-bo
globzono	glob-zo-no
gloraj	glo-r-aj
gloro	glo-ro
gluo	gluo
gluti	glu-ti
gobio	go-bio
goĥŝtejn	goĥ-ŝtejn
golfo	gol-fo
golgoto	gol-go-to
gorĝo	gor-ĝo
gorilo	go-ri-lo
goto	go-to
gracia	gra-cia
grado	gra-do
gradon	gra-d-on
grafemoj	gra-fe-m-oj
grafito	gra-fi-to
grajno	graj-no
gramatika	gra-ma-ti-ka
gramatikaj	gra-ma-ti-k-aj
gramatikaĵoj	gra-ma-ti-k-aĵ-oj
gramatikan	gra-ma-ti-k-an
gramatikiloj	gra-ma-ti-k-il-oj
gramatiko	gra-ma-ti-ko
gramatikon	gra-ma-ti-k-on
gramo	gra-mo
granato	gra-na-to
granda	granda
grandaj	grand-aj
grandan	grand-an
grandceremonian	grand-ce-re-mo-ni-an
grandanima	grand-a-ni-ma
grandaĝulo	grand-a-ĝ-ulo
grandeco	grand-eco
grandega	grand-ega
grandegaj	grand-eg-aj
grandegan	grand-eg-an
grandioza	gran-di-o-za
granduloj	grand-ul-oj
granito	gra-ni-to
granulo	gra-nu-lo
grasa	gra-sa
graso	gra-so
grati	gra-ti
gratulas	gra-tu-l-as
gratuli	gra-tu-li
gratulo	gra-tu-lo
graŭli	graŭ-li
grava	gra-va
gravaj	gra-v-aj
gravan	gra-v-an
gravas	gra-v-as
gravaspektan	gra-vas-pek-t-an
grave	gra-ve
graveco	gra-v-eco
gravecon	gra-v-ec-on
graveda	gra-ve-da
gravito	gra-vi-to
gravmiene	grav-mi-ene
gravo	gra-vo
gravtone	grav-tone
gravuloj	gra-v-ul-oj
grego	gre-go
grekan	gre-k-an
grenejo	gre-n-ejo
greno	gre-no
grenobla	gre-no-b-la
grilo	gri-lo
grimaci	gri-ma-ci
grimpi	grim-pi
grinci	grin-ci
gripo	gri-po
griza	gri-za
grizbarbulo	griz-bar-b-ulo
grizfela	griz-fe-la
grizhara	griz-hara
groto	gro-to
grumbli	grum-bli
grumo	gru-mo
grundo	grun-do
gruo	gruo
grupe	gru-pe
grupigo	gru-p-igo
grupo	gru-po
grupoj	gru-p-oj
grupon	gru-p-on
gruzglacio	gruz-gla-cio
gudro	gu-dro
gumo	gu-mo
gusto	gu-s-to
gustumi	gu-s-t-umi
guto	gu-to
gvardio	gvar-dio
gvidadis	gvi-d-ad-is
gvidi	gvi-di
gvidis	gvi-d-is
gvido	gvi-do
gvidus	gvi-d-us
ĝardeno	ĝar-de-no
ĝemas	ĝe-m-as
ĝemelo	ĝe-me-lo
ĝememi	ĝe-m-emi
ĝemi	ĝe-mi
ĝenas	ĝe-n-as
ĝendarmo	ĝen-dar-mo
ĝenerala	ĝe-ne-ra-la
ĝeneralaj	ĝe-ne-ra-l-aj
ĝenerale	ĝe-ne-ra-le
ĝeni	ĝe-ni
ĝenis	ĝe-n-is
ĝentila	ĝen-ti-la
ĝentileco	ĝen-ti-l-eco
ĝermo	ĝer-mo
ĝia	ĝia
ĝiaj	ĝiaj
ĝian	ĝian
ĝiavoje	ĝia-vo-je
ĝibo	ĝi-bo
ĝin	ĝin
ĝis	ĝis
ĝisfunde	ĝis-fun-de
ĝisnunaj	ĝis-nu-n-aj
ĝisvivos	ĝis-vi-v-os
ĝojas	ĝo-j-as
ĝoje	ĝo-je
ĝoji	ĝo-ji
ĝojis	ĝoj-is
ĝojo	ĝo-jo
ĝuas	ĝu-as
ĝusta	ĝu-s-ta
ĝustaj	ĝu-s-t-aj
ĝustan	ĝu-s-t-an
ĝustatempe	ĝu-s-ta-tem-pe
ĝuste	ĝu-s-te
hajlo	haj-lo
haki	ha-ki
hakilo	ha-k-ilo
haladzon	ha-la-d-z-on
haleluja	ha-le-lu-ja
halo	ha-lo
haltas	hal-t-as
haltejo	hal-t-ejo
halti	hal-ti
haltos	hal-t-os
Hamleto	ham-leto
hangaro	han-g-aro
harakiro	ha-ra-kiro
hararanĝo?	ha-r-aran-ĝo
hararo	ha-r-aro
harego	ha-re-go
haremo	ha-re-mo
haringo	ha-rin-go
harligo	har-li-go
harmoniigo	har-mo-ni-igo
harmonio	har-mo-nio
harmoniscienco	har-mo-ni-sci-en-co
haro	haro
haroj	har-oj
Haszpra	ha-sz-pra
haŭto	haŭ-to
havanta	ha-v-an-ta
havante	ha-v-an-te
havas	ha-v-as
haveno	ha-ve-no
havi	ha-vi
havigi	ha-v-igi
havis	ha-v-is
havos	ha-v-os
havu	ha-vu
havus	ha-v-us
hazarde	ha-zar-de
hazardo	ha-zar-do
hebrean	he-bre-an
heĝo	he-ĝo
hejma	hej-ma
hejmen	hej-men
hejmo	hej-mo
hejmon	hej-m-on
hejti	hej-ti
hektaro	hek-t-aro
hektolitro	hek-to-li-tro
hela	he-la
helikoptero	he-li-kop-te-ro
helpaj	help-aj
helpan	help-an
helpas	help-as
helpe	helpe
helpelementoj	help-ele-ment-oj
helpema	help-ema
helpi	helpi
helpilon	help-il-on
helpis	help-is
helplingvo	help-lin-g-vo
helpo	helpo
helpos	help-os
helpprogramo	help-pro-gra-mo
helpu	helpu
helpvortoj	help-vort-oj
hemnon	hem-n-on
henjo	he-njo
henriette	hen-ri-et-te
henrinjo	hen-ri-njo
hepato	he-pa-to
herbejo	her-b-ejo
herbo	her-bo
herboriĉa	her-bo-ri-ĉa
heredeco	he-re-d-eco
heredi	he-re-di
herkulo	her-ku-lo
hermafrodito	her-ma-fro-di-to
hermeto	her-me-to
herodoto	he-ro-do-to
heroeco	he-ro-eco
heroino	he-ro-ino
heroldo	he-rol-do
heroo	he-roo
hezitante	he-zi-t-an-te
hezitas	he-zi-t-as
heziti	he-zi-ti
hezitis	he-zi-t-is
hezito	he-zi-to
hezitus	he-zi-t-us
hiacinto	hi-acin-to
hibrido	hi-bri-do
hieraŭ	hi-e-raŭ
hierodulo	hi-e-ro-du-lo
hieroglifaj	hi-e-ro-gli-f-aj
higieno	hi-gi-e-no
himno	him-no
hindo	hin-do
hindujon	hin-d-uj-on
hipnoto	hi-p-no-to
hipokrito	hi-po-kri-to
hirundo	hi-run-do
hispanan	hi-s-pa-n-an
hispano	hi-s-pa-no
hispanujo	hi-s-pa-n-ujo
histo	hi-s-to
historiaj	hi-s-to-ri-aj
historian	hi-s-to-ri-an
historiisto	hi-s-to-ri-isto
historiistoj	hi-s-to-ri-ist-oj
historio	hi-s-to-rio
historion	hi-s-to-ri-on
historioskribantoj	hi-s-to-ri-o-skri-b-an-t-oj
hodiaŭ	ho-di-aŭ
hoko	ho-ko
homa	ho-ma
homaj	ho-m-aj
homaro	ho-m-aro
homaron	ho-m-ar-on
homo	ho-mo
homogenige	ho-mo-ge-n-ige
homoj	ho-m-oj
homon	ho-m-on
homonima	ho-mo-ni-ma
homonimaj	ho-mo-ni-m-aj
homonimo	ho-mo-ni-mo
homscienca	hom-sci-en-ca
homunkulo	ho-mun-ku-lo
honesta	ho-nes-ta
honestaj	ho-nes-t-aj
honestan	ho-nes-t-an
honeste	ho-nes-te
honesteco	ho-nes-t-eco
honestecon	ho-nes-t-ec-on
honora	ho-no-ra
honoran	ho-no-r-an
honoro	ho-no-ro
honoron	ho-no-r-on
honte	hon-te
honti	hon-ti
honto	hon-to
hordeo	hor-deo
horizontalo	ho-ri-zon-ta-lo
horizonto	ho-ri-zon-to
horloĝĉeneroj	hor-loĝ-ĉe-ne-r-oj
horloĝo	hor-lo-ĝo
horo	ho-ro
horoj	ho-r-oj
hospitalo	ho-s-pi-ta-lo
hotelo	ho-te-lo
hotentoto	ho-ten-to-to
hufbruo	huf-bruo
hufo	hu-fo
hufŝtalo	huf-ŝta-lo
humana	hu-ma-na
humida	hu-mi-da
humila	hu-mi-la
humilo	hu-mi-lo
humo	hu-mo
humoro	hu-mo-ro
humuron	hu-mu-r-on
hundobleki	hun-do-ble-ki
hungaro	hun-ga-ro
ĥano	ĥa-no
ĥaoso	ĥa-oso
ĥemiisto	ĥe-mi-isto
ĥemio	ĥe-mio
ĥeto	ĥeto
ĥlamido	ĥla-mi-do
ĥoro	ĥo-ro
iafoje	ia-foje
iaspecaj	ia-spe-c-aj
idaro	id-aro
ideaj	ide-aj
ideala	ide-ala
idealo	ide-alo
identa	iden-ta
identas	iden-t-as
ideo	ideo
ideoj	ide-oj
ideon	ide-on
idioteco	idi-o-t-eco
idiotoj	idi-o-t-oj
igas	ig-as
igemo	ig-emo
iginto	ig-in-to
ignoras	ig-no-r-as
ignori	ig-no-ri
igonto	ig-onto
igos	ig-os
igoto	igo-to
iĝas	iĝ-as
iĝemo	iĝ-emo
iĝis	iĝ-is
iĝonto	iĝ-onto
iĝos	iĝ-os
iĝu	iĝu
ilia	ilia
iliaj	ili-aj
ilian	ili-an
ilin	ilin
iloj	il-oj
ilon	il-on
ilustri	ilu-s-tri
iluzio	ilu-zio
imagas	ima-g-as
imagi	ima-gi
imagis	ima-g-is
imagon	ima-g-on
imagu	ima-gu
imitanta	imi-t-an-ta
imiti	imi-ti
imito	imi-to
imperiestrina	im-pe-ri-es-tr-ina
imperiestrinaj	im-pe-ri-es-tr-in-aj
imperiestrinajn	im-pe-ri-es-tr-in-ajn
imperiestrinan	im-pe-ri-es-tr-in-an
imperiestrine	im-pe-ri-es-tr-ine
imperiestrino	im-pe-ri-es-tr-ino
imperiestrinoj	im-pe-ri-es-tr-in-oj
imperiestrinojn	im-pe-ri-es-tr-in-ojn
imperiestrinon	im-pe-ri-es-tr-in-on
imperio	im-pe-rio
impeti	im-peti
impliki	im-pli-ki
imponas	im-po-n-as
imponi	im-po-ni
importi	im-por-ti
imposto	im-po-s-to
impreso	im-pre-so
impreson	im-pre-s-on
improvizitan	im-pro-vi-zi-t-an
impulso	im-pul-so
imuna	imu-na
incensbastoneto	in-cens-ba-s-to-n-eto
incido	in-ci-do
inciti	in-ci-ti
incito	in-ci-to
incognita	in-cog-n-ita
inda	inda
indecon	ind-ec-on
indeksnodo	in-deks-no-do
indeksnombro	in-deks-nom-bro
indeksofari	in-dek-so-fa-ri
indeksvica?	in-dek-s-vi-ca
indiferentaj	in-di-fe-ren-t-aj
indigni	in-dig-ni
indignigaj	in-dig-n-ig-aj
indigno	in-dig-no
indignos	in-dig-n-os
indigo	in-digo
indiĝeno	in-di-ĝe-no
indiĝo	ind-iĝo
indikas	in-di-k-as
indiki	in-di-ki
indikita	in-di-k-ita
indiko	in-di-ko
indikoj	in-di-k-oj
individuo	in-di-vi-duo
indo	indo
indulgi	in-dul-gi
industrio	in-du-s-trio
inerciaj	iner-ci-aj
inercio	iner-cio
inerciuloj	iner-ci-ul-oj
infana	in-fa-na
infanaj	in-fa-n-aj
infanaĵo	in-fa-n-aĵo
infanaĵoj	in-fa-n-aĵ-oj
infanan	in-fa-n-an
infane	in-fane
infaneco	in-fa-n-eco
infaniĝi	in-fa-n-iĝi
infanlingvaĵo	in-fan-lin-g-v-aĵo
infanlisto	in-fan-listo
infano	in-fa-no
infanoj	in-fa-n-oj
infanon	in-fa-n-on
infanŝteli	in-fan-ŝte-li
infanteriano	in-fan-te-ri-ano
infanto	in-fan-to
infanvoĉoj	in-fan-vo-ĉ-oj
infekti	in-fek-ti
inferan	in-fe-r-an
infero	in-fe-ro
infinito	in-fi-ni-to
influi	in-flui
influo	in-fluo
influon	in-flu-on
informa	in-for-ma
informi	in-for-mi
informiĝi	in-for-m-iĝi
informita	in-for-m-ita
informoj	in-for-m-oj
ingigo	ing-igo
inĝeniero	in-ĝe-ni-e-ro
inica	ini-ca
iniciati	ini-ci-ati
iniciatis	ini-ci-at-is
iniciativon	ini-ci-ati-v-on
iniciatoroj	ini-ci-ato-r-oj
injekti	in-jek-ti
injektis	in-jek-t-is
inklina	in-kli-na
inko	in-ko
inkognito	in-kog-ni-to
inksorbilo	ink-sor-b-ilo
inkujo	in-k-ujo
inokulo	ino-ku-lo
insekto	in-sek-to
insidi	in-si-di
insido	in-si-do
insigno	in-sig-no
insisti	in-si-s-ti
insisto	in-si-s-to
inspektoro	in-spek-to-ro
inspiri	in-spiri
inspiron	in-spir-on
instali	in-sta-li
instanbulo	in-stan-bu-lo
instanco	in-stan-co
instanto	in-stan-to
instigadi	in-sti-g-adi
instigi	in-sti-gi
instinkte	in-stink-te
instinkto	in-stink-to
institucio	in-sti-tu-cio
instituto	in-sti-tu-to
instruanto	ins-tru-an-to
instruantoj	ins-tru-an-t-oj
instruas	ins-tru-as
instrui	ins-trui
instruis	ins-tru-is
instruisto	ins-tru-isto
instruistoj	ins-tru-ist-oj
instruita	ins-tru-ita
instruitaj	ins-tru-it-aj
instruitulo	ins-tru-i-t-ulo
instruituloj	ins-tru-i-t-ul-oj
instrumento	ins-tru-men-to
instruu	ins-truu
insulino	in-su-li-no
insulo	in-su-lo
insulti	in-sul-ti
intaro	int-aro
inteco	int-eco
intelekto	in-te-lek-to
inteligenta	in-te-li-gen-ta
inteligentaj	in-te-li-gen-t-aj
inteligenteco	in-te-li-gen-t-eco
inteligentecon	in-te-li-gen-t-ec-on
intencas	in-ten-c-as
intence	in-ten-ce
intenci	in-ten-ci
intenco	in-ten-co
inter	in-ter
interalie	in-ter-alie
interan	in-ter-an
intere	in-tere
interesa	in-te-re-sa
interesaj	in-te-re-s-aj
interesas	in-te-re-s-as
interese	in-te-re-se
interesiĝas	in-te-re-s-iĝ-as
interesiĝis	in-te-re-s-iĝ-is
intereso	in-te-re-so
interesocentroj	in-te-re-so-cen-tr-oj
intereson	in-te-re-s-on
interezo	in-te-re-zo
interkompreniĝu	in-ter-kom-pre-n-iĝu
interkomprenon	in-ter-kom-pre-n-on
interkonsento	in-ter-kon-sen-to
interkonsentoj	in-ter-kon-sen-t-oj
interlingvistika	in-ter-lin-g-vi-s-ti-ka
intermeto	in-ter-meto
intermito	in-ter-mi-to
interna	in-ter-na
internacia	in-ter-na-cia
internaciaj	in-ter-na-ci-aj
internacian	in-ter-na-ci-an
internacieco	in-ter-na-ci-eco
internan	in-ter-n-an
interon	in-ter-on
interparolado	in-ter-pa-rol-ado
interparoladoj	in-ter-pa-rol-ad-oj
interparolas	in-ter-pa-rol-as
interparoli	in-ter-pa-roli
interparolo	in-ter-pa-rolo
interpelacii	in-ter-pe-la-cii
interpreti	in-ter-preti
interreta	in-ter-reta
interretaj	in-ter-ret-aj
interretajn	in-ter-ret-ajn
interretan	in-ter-ret-an
interrete	in-ter-rete
interreto	in-ter-reto
interreton	in-ter-ret-on
interrompis	in-ter-rom-p-is
interrompita	in-ter-rom-p-ita
intersoldata	in-ter-sol-da-ta
interŝanĝadi	in-ter-ŝan-ĝ-adi
interŝanĝado	in-ter-ŝan-ĝ-ado
interŝanĝadon	in-ter-ŝan-ĝ-ad-on
interŝanĝi	in-ter-ŝan-ĝi
interŝanĝo	in-ter-ŝan-ĝo
intertempe	in-ter-tem-pe
interuptoro	in-te-rup-to-ro
intervenis	in-ter-ve-n-is
intervjuoj	in-ter-vju-oj
intesto	in-tes-to
intima	in-ti-ma
intrigo	in-tri-go
inundi	inun-di
invado	in-va-do
invalido	in-va-li-do
inventaro	in-ven-ta-ro
inventi	in-ven-ti
inviti	in-vi-ti
inviton	in-vi-t-on
ioma	ioma
iomete	iomete
ipsilono	ip-si-lo-no
iradi	ir-adi
iradis	ir-ad-is
iranaj	ira-n-aj
iras	ir-as
irigas	ir-ig-as
irigi	ir-igi
iriloj	ir-il-oj
iris	ir-is
iron	ir-on
ironia	iro-nia
ironie	iro-nie
ironio	iro-nio
iros	ir-os
irus	ir-us
islamanoj	is-lam-a-n-oj
islamo	is-lamo
ismeco	ism-eco
israela	is-ra-ela
isteco	ist-eco
italan	ita-l-an
italo	ita-lo
iuj	iuj
iuokaze	iu-oka-ze
iusence	iu-sen-ce
iuspeca	iu-spe-ca
izobaro	izo-ba-ro
izolaj	izo-l-aj
izoli	izo-li
izraelido	iz-ra-el-ido
izraelo	iz-ra-elo
jacinto	ja-cin-to
jako	ja-ko
japana	ja-pa-na
jarcento	jar-cen-to
jarcentoj	jar-cen-t-oj
jardekoj	jar-de-k-oj
jaro	jaro
jaroj	jar-oj
jaron	jar-on
jena	je-na
jenaj	je-n-aj
jene	jene
jenon	je-n-on
jerusalemo	je-ru-sa-le-mo
jese	je-se
jesi	je-si
jesigi	je-s-igi
jida	jida
joĉjo	jo-ĉjo
johanĉjo	jo-han-ĉjo
johano	jo-ha-no
joto	jo-to
jubileo	ju-bi-leo
jubilo	ju-bi-lo
judo	ju-do
judoj	ju-d-oj
jugo	ju-go
jugularo	ju-gu-la-ro
juĝas	ju-ĝ-as
juĝi	ju-ĝi
juĝis	ju-ĝ-is
juĝloko	juĝ-lo-ko
juĝo	ju-ĝo
juĝon	ju-ĝ-on
juki	ju-ki
julio	ju-lio
julo	ju-lo
juna	juna
junaj	jun-aj
junan	jun-an
jungi	jun-gi
junio	junio
junulaj	jun-ul-aj
junularo	jun-ul-aro
junulino	jun-ul-ino
junulo	jun-ulo
junulon	jun-ul-on
jupiteroj	ju-pi-te-r-oj
jupo	ju-po
juristo	ju-r-isto
juro	ju-ro
justa	ju-s-ta
justecon	ju-s-t-ec-on
juvelo	ju-ve-lo
ĵaboto	ĵa-bo-to
ĵaketo	ĵa-ke-to
ĵaluza	ĵa-luza
ĵaŭdo	ĵaŭ-do
ĵetadi	ĵe-t-adi
ĵetados	ĵe-t-ad-os
ĵetas	ĵe-t-as
ĵeti	ĵe-ti
ĵeto	ĵe-to
ĵetu	ĵe-tu
ĵulo	ĵu-lo
ĵuri	ĵu-ri
ĵurnalisto	ĵur-na-l-isto
ĵurnalo	ĵur-na-lo
ĵurnaloj	ĵur-na-l-oj
ĵus	ĵus
ĵusnaskito	ĵus-na-s-k-ito
kaaba	ka-aba
kabano	ka-ba-no
kabineto	ka-bi-ne-to
kabulo	ka-bu-lo
kaĉaloto	ka-ĉa-lo-to
kaĉo	kaĉo
kadeto	ka-de-to
kadro	ka-dro
kaduka	ka-du-ka
kafmuelilon	kaf-mu-e-l-il-on
kafo	ka-fo
kafon	ka-f-on
kafpulvoro	kaf-pul-vo-ro
kahelo	ka-he-lo
kajero	ka-je-ro
kajo	ka-jo
kajuto	ka-ju-to
kakao	ka-kao
kakto	kak-to
kaldrono	kal-dro-no
kalendaro	ka-len-da-ro
kalendo	ka-len-do
kalendulo	ka-len-du-lo
kaleŝo	ka-le-ŝo
kaleŝservantoj	ka-leŝ-ser-v-an-t-oj
kaliko	ka-li-ko
kalikoto	ka-li-ko-to
kaliningrado	ka-li-nin-gra-do
kalkano	kal-ka-no
kalkanumo	kal-ka-n-umo
kalkulataj	kal-kul-at-aj
kalkulaŭtomatoj	kal-kul-aŭ-to-ma-t-oj
kalkuli	kal-kuli
kalkulis	kal-kul-is
kalkulo	kal-kulo
kalkuloj	kal-kul-oj
kalkulon	kal-kul-on
kalo	ka-lo
kalocsay	ka-lo-csay
kalsono	kal-so-no
kalumnii	ka-lum-nii
kalvinano	kal-vi-na-no
kamarado	ka-ma-ra-do
kamarilo	ka-ma-ri-lo
kamelo	ka-me-lo
kameno	ka-me-no
kamentubo	ka-men-tu-bo
kamforoleon?	kam-fo-r-ole-on
kamiono	ka-mi-o-no
kamloto	kam-lo-to
kamomilo	ka-mo-mi-lo
kampo	kam-po
kampoj	kam-p-oj
kanado	ka-na-do
kanalo	ka-na-lo
kandelingo	kan-del-ingo
kandelo	kan-de-lo
kandidato	kan-di-da-to
kanino	ka-ni-no
kankano	kan-ka-no
kankro	kan-kro
kano	ka-no
kanoto	ka-no-to
kantado	kan-t-ado
kantarelo	kan-ta-re-lo
kantarido	kan-ta-ri-do
kantaro	kan-t-aro
kanti	kan-ti
kantino	kan-ti-no
kanto	kan-to
kanzono	kan-zo-no
kapabla	ka-pa-b-la
kapablo	ka-pa-b-lo
kapacito	ka-pa-ci-to
kapeton	ka-pet-on
kapilaro	ka-pi-la-ro
kapitalo	ka-pi-ta-lo
kapitaloj	ka-pi-ta-l-oj
kapitano	ka-pi-ta-no
kapitulo	ka-pi-tu-lo
kapjesas	kap-je-s-as
kapkusenon	kap-ku-se-n-on
kapmoveton	kap-mo-v-et-on
kapo	ka-po
kapoj	ka-p-oj
kapon	ka-p-on
kapoto	ka-po-to
kaprica	ka-pri-ca
kapro	ka-pro
kapsulo	kap-su-lo
kaptas	kap-t-as
kapti	kap-ti
kaptilo	kap-t-ilo
kaptinto	kap-t-in-to
kaptintoj	kap-t-in-t-oj
kaptis	kap-t-is
kaptos	kap-t-os
kaptoŝnuro	kap-to-ŝnu-ro
kapuĉkovritaj	ka-puĉ-kov-rit-aj
kapzono	kap-zo-no
kara	kara
karafo	ka-ra-fo
karakterizo	ka-rak-te-ri-zo
karaktero	ka-rak-te-ro
karan	kar-an
karato	ka-ra-to
karavano	ka-ra-va-no
karbido?	kar-b-ido
karbo	kar-bo
karbonato?	kar-bo-n-ato
kardano	kar-da-no
karesi	ka-re-si
kariofilarbo	ka-ri-o-fil-arbo
karnavalo	kar-na-va-lo
karno	kar-no
karoto	ka-ro-to
karpo	kar-po
karto	kar-to
kartoĉhava	kar-toĉ-ha-va
kartono	kar-to-no
kasedaparato	ka-se-d-apa-ra-to
kasedon	ka-se-d-on
kaserolo	ka-se-ro-lo
kaskedo	ka-s-ke-do
kaslibro	kas-li-bro
kaso	ka-so
kastanjeto	ka-s-tan-je-to
kastelo	ka-s-te-lo
kaŝa	kaŝa
kaŝantaj	kaŝ-an-t-aj
kaŝas	kaŝ-as
kaŝe	kaŝe
kaŝejon	kaŝ-ej-on
kaŝi	kaŝi
kaŝis	kaŝ-is
kaŝita	kaŝ-ita
kaŝnomo	kaŝ-no-mo
kaŝobservi	kaŝ-ob-ser-vi
kaŝos	kaŝ-os
kaŝpasaĝero	kaŝ-pa-sa-ĝe-ro
kaŝpenso	kaŝ-pen-so
kaŝtano	kaŝ-ta-no
kaŝvizito	kaŝ-vi-zi-to
katalogo	ka-ta-lo-go
kataluna	ka-ta-lu-na
kataro	ka-t-aro
katedralo	ka-te-dra-lo
kategorieco	ka-te-go-ri-eco
kategoriecon	ka-te-go-ri-ec-on
kategorio	ka-te-go-rio
kategorioj	ka-te-go-ri-oj
kategorion	ka-te-go-ri-on
kateno	ka-te-no
kato	kato
katoliko	ka-to-li-ko
katolikoj	ka-to-li-k-oj
kaŭĉuko	kaŭ-ĉu-ko
kaŭzata	kaŭ-z-ata
kaŭzo	kaŭ-zo
kaŭzoj	kaŭ-z-oj
kavaĵo	ka-v-aĵo
kaverno	ka-ver-no
kavernon	ka-ver-n-on
kavo	ka-vo
kazaĥstana	ka-zaĥ-sta-na
kazemato	ka-ze-ma-to
kazo	ka-zo
kazon	ka-z-on
kejlo	kej-lo
kelka	kelka
kelkaj	kelk-aj
kelkan	kelk-an
kelke	kelke
kelkfoje	kelk-foje
kelktempe	kelk-tem-pe
kelnero	kel-ne-ro
kelneroj	kel-ne-r-oj
kelo	ke-lo
kemio	ke-mio
kerno	ker-no
kesto	kes-to
kiagrade	kia-gra-de
kiajn	kiajn
kial	kial
kialojn	kial-ojn
kiam	kiam
kiamaniere	kia-ma-ni-e-re
kian	kian
kiel	ki-el
kien	ki-en
kies	ki-es
kieson	ki-es-on
kilo	ki-lo
kilobajton	ki-lo-baj-t-on
kilobitokojn	ki-lo-bit-ok-ojn
kilogramo	ki-lo-gra-mo
kilometro	ki-lo-me-tro
kineto	ki-ne-to
kino	ki-no
kiom	kiom
kioma	kio-ma
kion	kion
kipĉakoj	kip-ĉa-k-oj
kirila	ki-ri-la
kirko	kir-ko
kirurgian	ki-rur-gi-an
kirurgio	ki-rur-gio
kirurgo	ki-rur-go
kisi	ki-si
kisto	ki-s-to
kitelo	ki-te-lo
kiuj	kiuj
kiun	kiun
kiusenca	kiu-sen-ca
kiuspeca	kiu-spe-ca
klaĉgazetaro	klaĉ-ga-ze-t-aro
klanjo	kla-njo
klappordo	klap-por-do
klara	kla-ra
klaran	kla-r-an
klare	kla-re
klareco	kla-r-eco
klarigas	kla-r-ig-as
klarigi	kla-r-igi
klarigis	kla-r-ig-is
klarigoj	kla-r-ig-oj
klarigon	kla-r-ig-on
klarigos	kla-r-ig-os
klariĝos	kla-r-iĝ-os
klarneto	klar-ne-to
klasĉambroj	klas-ĉam-br-oj
klasika	kla-si-ka
klasita	kla-s-ita
klasitaj	kla-s-it-aj
klaskonscia	kla-s-kon-scia
klaso	kla-so
klasoj	kla-s-oj
klavaro	klav-aro
klavoj	kla-v-oj
klavon	kla-v-on
klera	kle-ra
klerecnivelo	kle-rec-ni-ve-lo
kliento	kli-en-to
klimato	kli-ma-to
klingo	klin-go
klini	kli-ni
kliniko	kli-ni-ko
klopodi	klo-po-di
klozeto	klo-ze-to
klubĝardeno	klub-ĝar-de-no
klubo	klu-bo
knabino	kna-bi-no
knabinon	kna-bi-n-on
knabo	kna-bo
knaboj	kna-b-oj
knaro	knaro
knedi	kne-di
koagulo	ko-agu-lo
kofro	ko-fro
kofron	ko-fr-on
koincido	ko-in-ci-do
kojoto	ko-jo-to
koketa	ko-k-eta
kokidaĵo	ko-ki-d-aĵo
kokido	ko-k-ido
kokino	ko-ki-no
koko	ko-ko
kokoso	ko-ko-so
kolbason	kol-ba-s-on
kolegio	ko-le-gio
kolego	ko-le-go
kolegoj	ko-le-g-oj
kolektiĝis	ko-lek-t-iĝ-is
kolektiĝos	ko-lek-t-iĝ-os
kolektis	ko-lek-t-is
kolektita	ko-lek-t-ita
kolektiva	ko-lek-ti-va
kolekto	ko-lek-to
kolektoj	ko-lek-t-oj
kolekton	ko-lek-t-on
koleri	ko-le-ri
kolharoj	kol-har-oj
kolĥozo	kol-ĥo-zo
kolizii	ko-li-zii
kolo	ko-lo
kolombo	ko-lom-bo
kolonelo	ko-lo-ne-lo
kolono	ko-lo-no
koloro	ko-lo-ro
kolumbo	ko-lum-bo
kolumno	ko-lum-no
kolumo	ko-l-umo
komandi	ko-man-di
komato	ko-ma-to
kombi	kom-bi
kombilo	kom-b-ilo
kombini	kom-bi-ni
komedio	ko-me-dio
komencante	ko-men-c-an-te
komencas	ko-men-c-as
komence	ko-men-ce
komenci	ko-men-ci
komenciĝis	ko-men-c-iĝ-is
komenciĝos	ko-men-c-iĝ-os
komencis	ko-men-c-is
komenco	ko-men-co
komencos	ko-men-c-os
komentis	ko-men-t-is
komerca	ko-mer-ca
komercaĵo	ko-mer-c-aĵo
komerci	ko-mer-ci
komercisto	ko-mer-c-isto
komerckonsilanedzino	ko-merc-kon-si-la-n-edzi-no
komercpakego	ko-merc-pa-k-ego
kometo	ko-me-to
komforta	kom-for-ta
komfortaj	kom-for-t-aj
komforte	kom-for-te
komika	ko-mi-ka
komisaro	ko-mi-sa-ro
komisii	ko-mi-sii
komisiono	ko-mi-si-o-no
komitato	ko-mi-ta-to
komitatoj	ko-mi-ta-t-oj
komitaton	ko-mi-ta-t-on
komo	ko-mo
kompanio	kom-pa-nio
komparado	kom-pa-r-ado
komparadon	kom-pa-r-ad-on
komparas	kom-pa-r-as
kompareblan	kom-pa-r-eb-l-an
kompari	kom-pa-ri
komparo	kom-pa-ro
kompatemon	kom-pa-te-m-on
kompati	kom-pa-ti
kompatinda	kom-pa-t-inda
kompato	kom-pa-to
kompatu	kom-pa-tu
kompense	kom-pen-se
kompensi	kom-pen-si
kompetenta	kom-pe-ten-ta
kompetentan	kom-pe-ten-t-an
kompilado	kom-pi-l-ado
kompili	kom-pi-li
kompilo	kom-pi-lo
komplemento	kom-ple-men-to
kompleta	kom-ple-ta
kompletiga	kom-ple-t-iga
kompletigas	kom-ple-t-ig-as
kompletigi	kom-ple-t-igi
komplezi	kom-ple-zi
komplika	kom-pli-ka
komplikanta	kom-pli-kan-ta
kompliki	kom-pli-ki
komplikita	kom-pli-k-ita
komplikitaj	kom-pli-k-it-aj
kompliko	kom-pli-ko
komploto	kom-plo-to
komponi	kom-po-ni
kompoto	kom-po-to
kompozicion	kom-po-zi-ci-on
komprenadi	kom-pre-n-adi
komprenados	kom-pre-n-ad-os
komprenaĵo	kom-pre-n-aĵo
komprenaĵon	kom-pre-n-aĵ-on
komprenantaj	kom-pre-n-an-t-aj
komprenante	kom-pre-n-an-te
komprenas	kom-pre-n-as
komprenata	kom-pre-n-ata
komprene	kom-prene
komprenebla	kom-pre-n-eb-la
kompreneble	kom-pre-n-eb-le
komprenetadi	kom-pre-ne-t-adi
kompreni	kom-pre-ni
komprenigi	kom-pre-n-igi
kompreniĝadi	kom-pre-n-iĝ-adi
kompreniĝadis	kom-pre-n-iĝ-ad-is
kompreniĝado	kom-pre-n-iĝ-ado
komprenis	kom-pre-n-is
komprenos	kom-pre-n-os
komprenu	kom-pre-nu
kompromiti	kom-pro-mi-ti
kompromito	kom-pro-mi-to
komputado	kom-pu-t-ado
komputadoj	kom-pu-t-ad-oj
komputilo	kom-put-ilo
komputiloj	kom-put-il-oj
komputoscienca	kom-pu-to-sci-en-ca
komputosciencon	kom-pu-to-sci-en-c-on
komuna	ko-mu-na
komunaj	ko-mu-n-aj
komunan	ko-mu-n-an
komune	ko-mune
komuneakceptitan	ko-mu-ne-ak-cep-t-it-an
komunehoman	ko-mu-ne-ho-m-an
komuniki	ko-mu-niki
komunikiĝadi	ko-mu-nik-iĝ-adi
komunikiĝado	ko-mu-nik-iĝ-ado
komunikiĝoj	ko-mu-nik-iĝ-oj
komunikita	ko-mu-nik-ita
komunikreto	ko-mu-nik-reto
komunumo	ko-mu-n-umo
konantaj	ko-n-an-t-aj
konas	ko-n-as
konata	ko-n-ata
konataj	ko-n-at-aj
konatiĝante	ko-na-t-iĝ-an-te
konatiĝi	ko-na-t-iĝi
konatiĝinte	ko-na-t-iĝ-in-te
konatiĝis	ko-na-t-iĝ-is
konatiĝo	ko-na-t-iĝo
konatiĝu	ko-na-t-iĝu
konatiĝus	ko-na-t-iĝ-us
koncentri	kon-cen-tri
koncepto	kon-cep-to
konceptoj	kon-cep-t-oj
koncerna	kon-cer-na
koncernaj	kon-cer-n-aj
koncernas	kon-cer-n-as
koncerne	kon-cerne
koncerni	kon-cer-ni
koncernis	kon-cer-n-is
koncerto	kon-cer-to
kondamni	kon-dam-ni
kondiĉa	kon-di-ĉa
kondiĉaj	kon-di-ĉ-aj
kondiĉo	kon-di-ĉo
kondiĉoj	kon-di-ĉ-oj
kondukas	kon-du-k-as
konduki	kon-du-ki
kondukilo	kon-du-k-ilo
kondukis	kon-du-k-is
kondukos	kon-du-k-os
kondukŝnuro	kon-duk-ŝnu-ro
konduti	kon-du-ti
konduto	kon-du-to
konferenco	kon-fe-ren-co
konfesanto	kon-fe-s-an-to
konfesas	kon-fe-s-as
konfesi	kon-fe-si
konfesinde	kon-fe-s-inde
konfeto	kon-fe-to
konfidenco	kon-fi-den-co
konfidi	kon-fi-di
konfido	kon-fi-do
konfirmas	kon-fir-m-as
konfirmi	kon-fir-mi
konfitaĵo	kon-fi-t-aĵo
konfiti	kon-fi-ti
konfito	kon-fi-to
konflikto	kon-flik-to
konforma	kon-for-ma
konformaj	kon-for-m-aj
konforme	kon-for-me
konformigadi	kon-for-m-ig-adi
konfronto	kon-fron-to
konfuzaĵoj	kon-fuz-aĵ-oj
konfuzi	kon-fuzi
konfuziĝados	kon-fuz-iĝ-ad-os
konfuziĝas	kon-fuz-iĝ-as
konfuzitaj	kon-fuz-it-aj
konfuzon	kon-fuz-on
konfuzu	kon-fuzu
kongresanoj	kon-gre-sa-n-oj
kongreso	kon-gre-so
kongresoj	kon-gre-s-oj
kongreson	kon-gre-s-on
koni	ko-ni
konjekti	kon-jek-ti
konjekto	kon-jek-to
konjugacii	kon-ju-ga-cii
konjugacioj	kon-ju-ga-ci-oj
konjunkcio	kon-junk-cio
konkludi	kon-klu-di
konkludo	kon-klu-do
konkludoj	kon-klu-d-oj
konkludon	kon-klu-d-on
konkordato	kon-kor-da-to
konkordo	kon-kor-do
konkreta	kon-kre-ta
konkretaj	kon-kre-t-aj
konkretan	kon-kre-t-an
konkurado	kon-ku-r-ado
konkurantoj	kon-ku-r-an-t-oj
konkuri	kon-ku-ri
konkurso	kon-kur-so
konon	ko-n-on
konscia	kon-scia
konsciante	kon-sci-an-te
konsciata	kon-sci-ata
konscie	kon-scie
konscienca	kon-sci-en-ca
konsciencdubo	kon-sci-enc-du-bo
konscienco	kon-sci-en-co
konsciencriproĉo	kon-sci-enc-ri-pro-ĉo
konscii	kon-scii
konsciis	kon-sci-is
konsciita	kon-sci-ita
konscio	kon-scio
konscion	kon-sci-on
konsciperdo	kon-sci-per-do
konsekvenco	kon-se-k-ven-co
konsent	kon-sent
konsentas	kon-sen-t-as
konsenteco	kon-sen-t-eco
konsenti	kon-sen-ti
konsentigi	kon-sen-t-igi
konsentiĝi	kon-sen-t-iĝi
konsentinta	kon-sen-t-in-ta
konsentis	kon-sen-t-is
konsentite	kon-sen-t-ite
konsentos	kon-sen-t-os
konsentus	kon-sen-t-us
konservadi	kon-ser-v-adi
konservi	kon-ser-vi
konservinte	kon-ser-v-in-te
konsideras	kon-si-de-r-as
konsiderata	kon-si-de-r-ata
konsiderebla	kon-si-de-r-eb-la
konsideri	kon-si-de-ri
konsideris	kon-si-de-r-is
konsideritan	kon-si-de-r-it-an
konsideroj	kon-si-de-r-oj
konsideros	kon-si-de-r-os
konsili	kon-si-li
konsilo	kon-si-lo
konsistanta	kon-si-s-t-an-ta
konsistantan	kon-si-s-t-an-t-an
konsistas	kon-si-s-t-as
konsisti	kon-si-s-ti
konsistigus	kon-si-s-t-ig-us
konsistis	kon-si-s-t-is
konsisto	kon-si-s-to
konsiston	kon-si-s-t-on
konsistos	kon-si-s-t-os
konsistus	kon-si-s-t-us
konsoli	kon-so-li
konsonanton	kon-so-nan-t-on
konstanta	kon-stan-ta
konstantaj	kon-stan-t-aj
konstante	kon-stan-te
konstanton	kon-stan-t-on
konstatas	kon-sta-t-as
konstatis	kon-sta-t-is
konstatoj	kon-sta-t-oj
konstitucio	kon-sti-tu-cio
konstruado	kons-tru-ado
konstruaĵo	kons-tru-aĵo
konstrui	kons-trui
konstruiĝadis	kons-tru-iĝ-ad-is
konstruiĝis	kons-tru-iĝ-is
konstruitaj	kons-tru-it-aj
konstruo	kons-truo
konstruon	kons-tru-on
konstruos	kons-tru-os
konsulo	kon-su-lo
konsultas	kon-sul-t-as
konsultejo	kon-sul-t-ejo
konsumi	kon-su-mi
kontanta	kon-t-an-ta
kontenta	kon-ten-ta
kontentigaj	kon-ten-t-ig-aj
kontentigan	kon-ten-t-ig-an
kontentigas	kon-ten-t-ig-as
kontentige	kon-ten-t-ige
kontentigi	kon-ten-t-igi
kontentiĝas	kon-ten-t-iĝ-as
kontesti	kon-tes-ti
kontinento	kon-ti-nen-to
konto	kon-to
kontrakti	kon-trak-ti
kontrakto	kon-trak-to
kontraktoj	kon-trak-t-oj
kontraste	kon-tra-s-te
kontraŭ	kon-traŭ
kontraŭa	kon-traŭa
kontraŭagadu	kon-traŭ-ag-adu
kontraŭaj	kon-traŭ-aj
kontraŭan	kon-traŭ-an
kontraŭdiro	kon-traŭ-diro
kontraŭe	kon-traŭe
kontraŭmalsana	kon-traŭ-mal-sa-na
kontraŭon	kon-traŭ-on
kontraŭparolantaj	kon-traŭ-pa-rol-an-t-aj
kontraŭparoli	kon-traŭ-pa-roli
kontraŭparoloj	kon-traŭ-pa-rol-oj
kontraŭuloj	kon-traŭ-ul-oj
kontraŭvole	kon-traŭ-vo-le
kontroleblaj	kon-tro-l-eb-l-aj
kontroli	kon-tro-li
kontrolis	kon-tro-l-is
konvalo	kon-va-lo
konvena	kon-ve-na
konvenas	kon-ve-n-as
konversacii	kon-ver-sa-cii
konvinki	kon-vin-ki
konvinkiĝadi	kon-vin-k-iĝ-adi
konvinkiĝas	kon-vin-k-iĝ-as
konvinkiĝi	kon-vin-k-iĝi
konvinkiĝos	kon-vin-k-iĝ-os
konvinko	kon-vin-ko
konvinkoj	kon-vin-k-oj
konvinkos	kon-vin-k-os
kopiado	ko-pi-ado
kopio	ko-pio
kopioj	ko-pi-oj
kopius	ko-pi-us
kopulo	ko-pu-lo
koran	ko-r-an
korano	ko-ra-no
korbo	kor-bo
kordo	kor-do
kore	ko-re
korekscita	ko-r-eks-ci-ta
korekta	ko-rek-ta
korektado	ko-rek-t-ado
korektanta	ko-rek-t-an-ta
korektas	ko-rek-t-as
korekti	ko-rek-ti
korektis	ko-rek-t-is
korekto	ko-rek-to
korespondi	ko-re-s-pon-di
koridora	ko-ri-do-ra
koridoro	ko-ri-do-ro
koridoron	ko-ri-do-r-on
korinklino??	ko-rin-kli-no?
korko	kor-ko
korktirilo	kork-tir-ilo
korniko	kor-ni-ko
korno	kor-no
koro	ko-ro
koron	ko-r-on
korpan	kor-p-an
korpbalanco	korp-ba-lan-co
korpmezurojn	korp-me-zur-ojn
korpo	kor-po
korporacioj	kor-po-ra-ci-oj
korpuskulo	kor-pu-s-ku-lo
korseto	kor-se-to
kortegjunuloj	kor-teg-jun-ul-oj
kortego	kor-t-ego
korto	kor-to
korveto	kor-ve-to
korvo	kor-vo
kosmo	kos-mo
kosta	ko-s-ta
kostas	ko-s-t-as
kosti	ko-s-ti
kostoj	ko-s-t-oj
kostumo	ko-s-tu-mo
koŝmara	koŝ-mara
kotleto	kot-le-to
koto	ko-to
koton	ko-t-on
kotono	ko-to-no
koverto	ko-ver-to
kovraĵo	kov-raĵo
kovranta	kov-ran-ta
kovrilo	kov-rilo
kovris	kov-ris
kovro	kov-ro
kraĉi	kra-ĉi
kraĉŝprucis	kraĉ-ŝpru-c-is
krado	krado
krajono	kra-jo-no
kranio	kra-nio
krano	kra-no
krasnojarskanino	kras-no-jar-ska-ni-no
kravato	kra-va-to
kreado	kre-ado
kreadon	kre-ad-on
kreas	kre-as
kredas	kre-d-as
kredebla	kre-d-eb-la
kredeble	kre-d-eb-le
kredebleco	kre-d-eb-l-eco
kredema	kre-d-ema
kredi	kre-di
kredigas	kre-d-ig-as
kredigi	kre-d-igi
kredinda	kre-d-inda
kredito	kre-di-to
kredu	kre-du
krei	krei
kreiĝis	kre-iĝ-is
kreis	kre-is
kreita	kre-ita
kreitaĵoj	kre-i-t-aĵ-oj
kremo	kremo
kreo	kreo
kreos	kre-os
kreozoto	kre-o-zo-to
krepusko	kre-pu-s-ko
kresĉenda	kres-ĉen-da
kreskadus	kre-s-k-ad-us
kreskaĵo	kre-s-k-aĵo
kreskanta	kre-s-kan-ta
kreski	kre-s-ki
kresto	kres-to
krestomatio	kres-to-ma-tio
kreto	kreto
krevi	kre-vi
kriaĉas	kri-aĉ-as
kriaĉis	kri-aĉ-is
kriantan	kri-an-t-an
kriante	kri-an-te
krias	kri-as
kribrado	kri-br-ado
krie	krie
kriegis	kri-eg-is
kriema	kri-ema
kriemuloj	kri-em-ul-oj
krii	krii
kriis	kri-is
kriistoj	kri-ist-oj
kriketo	kri-ke-to
kriman	kri-m-an
krimo	kri-mo
kringo	krin-go
krios	kri-os
kripla	kri-pla
kripliĝas	kri-pl-iĝ-as
kriptaĵoscienco	krip-ta-ĵo-sci-en-co
kriptografio	krip-to-gra-fio
kristalo	kri-s-ta-lo
kristaneco	kri-s-ta-n-eco
kristano	kri-s-ta-no
kristnasko	krist-na-s-ko
kristo	kri-s-to
kriterioj	kri-te-ri-oj
kritika	kri-ti-ka
kritikantoj	kri-ti-kan-t-oj
kritike	kri-ti-ke
kritiki	kri-ti-ki
krizalido	kri-za-li-do
krizantemo	kri-zan-te-mo
krizo	kri-zo
kroĉi	kro-ĉi
kroketo	kro-ke-to
krokodilo	kro-ko-di-lo
krom	krom
kroma	kroma
kromaj	krom-aj
kromajn	krom-ajn
kroman	krom-an
kromato	kro-ma-to
krome	krome
kromiajn	kro-mi-ajn
kromion	kro-mi-on
kromobjekto	kromob-jek-to
kromosomo	kromo-so-mo
krompecoj	krom-pe-c-oj
krono	kro-no
krozŝipoj	kroz-ŝip-oj
kruciĝado	kru-c-iĝ-ado
kruco	kru-co
krucon	kru-c-on
krucsigno	kruc-sig-no
krucumi	kru-c-umi
kruĉo	kru-ĉo
kruda	kru-da
kruela	kru-e-la
kruro	kru-ro
kruroj	kru-r-oj
krusto	kru-s-to
kruta	kru-ta
kruzejroj	kru-zej-r-oj
kubĵetoj	kub-ĵe-t-oj
kubo	ku-bo
kubuto	ku-bu-to
kudri	ku-dri
kudrilo	ku-dr-ilo
kuglo	ku-glo
kuirejo	ku-ir-ejo
kuiri	ku-iri
kuiristo	ku-ir-isto
kuko	ku-ko
kukolo	ku-ko-lo
kukon	ku-k-on
kukumo	ku-ku-mo
kukurbo	ku-kur-bo
kulero	ku-le-ro
kulinaro	ku-li-na-ro
kulo	ku-lo
kuloto	ku-lo-to
kulpa	kul-pa
kulpo	kul-po
kulpulo	kul-p-ulo
kultivi	kul-ti-vi
kulto	kul-to
kulturaj	kul-tu-r-aj
kulturi	kul-tu-ri
kulturo	kul-tu-ro
kulturon	kul-tu-r-on
kumulo	ku-mu-lo
kune	kune
kunekzisti	kun-ek-zi-s-ti
kunesto	kun-es-to
kunfluiĝo	kun-flu-iĝo
kunigas	kun-ig-as
kunigi	kun-igi
kunigo	kun-igo
kuniĝoj	kun-iĝ-oj
kuniklo	ku-ni-klo
kunkreskiĝis	kun-kre-s-k-iĝ-is
kunlaboranton	kun-la-bo-r-an-t-on
kunlaboras	kun-la-bo-r-as
kunlabori	kun-la-bo-ri
kunlaboron	kun-la-bo-r-on
kunlaboros	kun-la-bo-r-os
kunlaboru	kun-la-bo-ru
kunmetaĵoj	kun-me-t-aĵ-oj
kunmeti	kun-meti
kunmetita	kun-me-t-ita
kunpuŝiĝante	kun-pu-ŝ-iĝ-an-te
kunpuŝiĝo	kun-pu-ŝ-iĝo
kunsenti	kun-sen-ti
kunsido	kun-sido
kunteksto	kun-tek-s-to
kuntiri	kun-tiri
kunulino	kun-ul-ino
kunulo	kun-ulo
kunuloj	kun-ul-oj
kunveni	kun-ve-ni
kunveturi	kun-ve-tu-ri
kunveturiĝis	kun-ve-tu-r-iĝ-is
kupono	ku-po-no
kupro	ku-pro
kuracado	ku-ra-c-ado
kuraci	ku-ra-ci
kuracilo	ku-ra-c-ilo
kuracistedzino	ku-ra-ci-s-t-edzi-no
kuracistino	ku-ra-c-ist-ino
kuracistinoj	ku-ra-c-ist-in-oj
kuracisto	ku-ra-c-isto
kuraciston	ku-ra-c-ist-on
kuradĉaso	ku-rad-ĉa-so
kuradis	ku-r-ad-is
kuraĝa	ku-ra-ĝa
kuraĝas	ku-ra-ĝ-as
kuraĝe	ku-ra-ĝe
kuraĝhava	ku-raĝ-ha-va
kuraĝo	ku-ra-ĝo
kuraĝon	ku-ra-ĝ-on
kuraĝos	ku-ra-ĝ-os
kurbo	kur-bo
kurento	ku-ren-to
kuri	ku-ri
kurioza	ku-ri-o-za
kuris	ku-r-is
kuro	ku-ro
kursivaj	kur-si-v-aj
kursmaterialo	kurs-ma-te-ri-alo
kurso	kur-so
kursoj	kur-soj
kurteno	kur-te-no
kurzfluktuojn	kurz-fluk-tu-ojn
kurznivelon	kurz-ni-ve-l-on
kusenego	ku-se-n-ego
kuseno	ku-se-no
kuŝas	ku-ŝ-as
kuŝbenko	kuŝ-ben-ko
kuŝe	ku-ŝe
kuŝi	ku-ŝi
kuŝigos	ku-ŝ-ig-os
kuŝis	ku-ŝ-is
kuŝu	ku-ŝu
kuŝus	ku-ŝ-us
kutima	ku-ti-ma
kutime	ku-ti-me
kutimi	ku-ti-mi
kutiminta	ku-ti-m-in-ta
kutimis	ku-ti-m-is
kutimoj	ku-ti-m-oj
kutimon	ku-ti-m-on
kuvo	ku-vo
kuzo	ku-zo
kvadranto	kva-dran-to
kvadrato	kva-dra-to
kvadrigo	kva-dri-go
kvalito	kva-li-to
kvalitoj	kva-li-t-oj
kvaliton	kva-li-t-on
kvankam	kvan-kam
kvanta	kvan-ta
kvanto	kvan-to
kvanton	kvan-t-on
kvar	kvar
kvarangulojn	kvar-an-gu-l-ojn
kvardek	kvar-dek
kvarjaran	kvar-jar-an
kvarono	kvar-o-no
kvaropo	kvar-opo
kvartalo	kvar-ta-lo
kvaternaro	kva-ter-na-ro
kvazaŭ	kva-zaŭ
kvazaŭscienca	kva-zaŭ-sci-en-ca
kvazaŭsciencaj	kva-zaŭ-sci-en-c-aj
kverko	kver-ko
kvieta	kvi-eta
kvin	kvin
kvinangule	kvin-an-gu-le
kvindek	kvin-dek
kvinjara	kvin-jara
kvinono	kvin-o-no
kvinope	kvin-ope
kvintesenco	kvin-t-esen-co
kvintoj	kvin-t-oj
kvito	kvi-to
kvivito	kvi-vi-to
kvodlibeto	kvod-li-be-to
kvorumo	kvo-ru-mo
kvoto	kvo-to
labirinto	la-bi-rin-to
laboradi	la-bo-r-adi
laborado	la-bo-r-ado
laboradon	la-bo-r-ad-on
laboranto	la-bo-r-an-to
laborantoj	la-bo-r-an-t-oj
laboras	la-bo-r-as
laboratorio	la-bo-ra-to-rio
laboremaj	la-bo-r-em-aj
laborenspezon?	la-bo-ren-spe-z-on
labori	la-bo-ri
laborinta	la-bo-r-in-ta
laboris	la-bo-r-is
laborjaroj	la-bor-jar-oj
laboro	la-bo-ro
laboroj	la-bo-r-oj
laboron	la-bo-r-on
laca	la-ca
lacaj	la-c-aj
lacega	la-c-ega
lacerto	la-cer-to
laciga	la-c-iga
lacigi	la-c-igi
lacigitaj	la-c-ig-it-aj
laciĝos	la-c-iĝ-os
laĉo	laĉo
lado	lado
lageto	la-g-eto
lago	la-go
lako	la-ko
lakto	lak-to
laktumo	lak-t-umo
lama	la-ma
lambastono	lam-ba-s-to-no
lame	la-me
lameno	la-me-no
lampfabrikon	lamp-fab-ri-k-on
lampo	lam-po
lampŝirmilon	lamp-ŝir-mi-l-on
landlimo	land-li-mo
lando	lan-do
landoj	lan-d-oj
lango	lan-go
lano	la-no
lanterno	lan-ter-no
lapidaro	la-pi-da-ro
lapo	la-po
lardo	lar-do
larĝa	lar-ĝa
larĝe	lar-ĝe
larĝnazaj	larĝ-na-z-aj
larĝŝultra	larĝ-ŝul-tra
laringo	la-rin-go
larmo	lar-mo
larvo	lar-vo
lasante	la-s-an-te
lasas	la-s-as
lasi	la-si
lasis	la-s-is
lasita	la-s-ita
lasos	la-s-os
lasta	la-s-ta
lastaj	la-s-t-aj
lastan	la-s-t-an
lastfoje	last-foje
lasu	la-su
lasus	la-s-us
latina	la-ti-na
latinan	la-ti-n-an
latino	la-ti-no
latitudo	la-ti-tu-do
latuno	la-tu-no
laŭ	laŭ
laŭbo	laŭ-bo
laŭdata	laŭda-ta
laŭdi	laŭ-di
laŭdinda	laŭd-inda
laŭekzempla	laŭ-ek-zem-pla
laŭesence	laŭ-esen-ce
laŭetape	laŭ-eta-pe
laŭimaga	laŭ-ima-ga
laŭinteresaj	laŭ-in-te-re-s-aj
laŭlarĝe	laŭ-lar-ĝe
laŭlonge	laŭ-longe
laŭokaze	laŭ-oka-ze
laŭorda	laŭ-or-da
laŭregula	laŭ-re-gula
laŭregule	laŭ-re-gule
laŭta	laŭ-ta
laŭtaj	laŭ-t-aj
laŭte	laŭ-te
laŭtega	laŭ-t-ega
laŭtlegis	laŭt-leg-is
laŭukaza	laŭ-uka-za
lavabo	la-va-bo
lavado	la-v-ado
lavaĵkorbo	la-vaĵ-kor-bo
lavakvo?	la-v-ak-vo
lavango	la-van-go
lavĉifono	lav-ĉi-fo-no
lavendo	la-ven-do
lavi	la-vi
lavistino	la-v-ist-ino
lavvazo	lav-va-zo
leciono	le-ci-o-no
lecionoj	le-ci-o-n-oj
ledo	le-do
legado	le-g-ado
leganta	le-g-an-ta
legante	le-g-an-te
legantoj	le-g-an-t-oj
legas	le-g-as
legebla	le-g-eb-la
legi	le-gi
leginto	le-g-in-to
legis	le-g-is
legitima	le-gi-ti-ma
lego	le-go
legofacilon	le-go-fa-ci-l-on
legomĝardenoj	le-gom-ĝar-de-n-oj
legomo	le-go-mo
legos	le-g-os
legoscia	le-go-scia
legu	le-gu
leĝdonanto	leĝ-do-n-an-to
leĝon	le-ĝ-on
leĝoscienco	le-ĝo-sci-en-co
leĝsciencisto	leĝ-sci-en-c-isto
Lejbnico	lejb-ni-co
lekcio	lek-cio
leki	le-ki
leksemo?	lek-s-emo
leksikan	lek-si-k-an
leksikologiaj	lek-si-ko-lo-gi-aj
leksikologo	lek-si-ko-lo-go
lemo	le-mo
leono	le-o-no
leporo	le-po-ro
lernadi	ler-n-adi
lernado	ler-n-ado
lernanto	ler-n-an-to
lernantoj	ler-n-an-t-oj
lernas	ler-n-as
lernejaj	ler-n-ej-aj
lernejajn	ler-n-ej-ajn
lernejan	ler-n-ej-an
lernejĉambro	ler-nej-ĉam-bro
lerneje	ler-n-eje
lernejo	ler-n-ejo
lernejoj	ler-n-ej-oj
lernejojn	ler-n-ej-ojn
lerni	ler-ni
lerninta	ler-n-in-ta
lerno	ler-no
lernolibran	ler-no-li-br-an
lernolibro	ler-no-li-bro
lernolibroj	ler-no-li-br-oj
lernolibron	ler-no-li-br-on
lerta	ler-ta
lesivo	le-si-vo
lêtenanto	lê-te-nan-to
leteron	le-te-r-on
leterpapero	le-ter-pa-pe-ro
leŭtenanto	leŭ-te-nan-to
levĉenojn	lev-ĉe-n-ojn
levi	le-vi
leviĝadi	le-v-iĝ-adi
leviĝis	le-v-iĝ-is
leviĝus	le-v-iĝ-us
levilo	le-v-ilo
levis	le-v-is
liaj	liaj
lialanda	lia-lan-da
lialingva	lia-lin-g-va
lian	li-an
lianoj	li-a-n-oj
liaso	li-a-so
liaurba	lia-ur-ba
libera	li-be-ra
libere	li-be-re
libereco	li-be-r-eco
liberi	li-be-ri
liberigi	li-be-r-igi
liberigitaj	li-be-r-ig-it-aj
liberigu	li-be-r-igu
liberiĝinte	li-be-r-iĝ-in-te
liberon	li-be-r-on
libertempi	li-ber-tem-pi
libido	li-bi-do
libreto	li-breto
libro	li-bro
libroj	li-br-oj
librotenanto	li-bro-te-n-an-to
licenco	li-cen-co
liceo	li-ceo
lido	lido
lifto	lif-to
ligas	lig-as
ligaturo	liga-tu-ro
ligis	lig-is
ligita	lig-ita
ligiteco	lig-it-eco
lignaĵbudoj	lig-naĵ-bu-d-oj
lignaĵisto	lig-na-ĵ-isto
lignaĵlaboriloj	lig-naĵ-la-bo-r-il-oj
ligno	lig-no
ligo	ligo
ligŝnuro	lig-ŝnu-ro
liĥtenŝtejna	liĥ-ten-ŝtej-na
likvakristalajn	li-k-va-kri-s-ta-l-ajn
likvido	li-k-vi-do
likvo	li-k-vo
lilio	li-lio
limako	li-ma-ko
limfjordo	lim-fjor-do
limigi	li-m-igi
limigita	li-m-ig-ita
limigitan	li-m-ig-it-an
limita	li-mi-ta
limo	li-mo
limonado	li-mo-na-do
linda	lin-da
lingvaj	lin-g-v-aj
lingve	lin-g-ve
lingvistika	lin-g-vi-s-ti-ka
lingvistiko	lin-g-vi-s-ti-ko
lingvistikon	lin-g-vi-s-ti-k-on
lingvistoj	lin-g-v-ist-oj
lingvo	lin-g-vo
lingvoj	lin-g-v-oj
lingvokonon	lin-g-vo-ko-n-on
lingvon	lin-g-v-on
lingvoscienca	lin-g-vo-sci-en-ca
lingvoscio	lin-g-vo-scio
lingvotrunkon	lin-g-vo-trun-k-on
lingvouzo	lin-g-vo-uzo
lingvuzon	lingv-uz-on
linio	li-nio
lino	li-no
linoleo?	li-n-oleo
lipharoj	lip-har-oj
lipo	li-po
listo	li-s-to
listoj	li-s-t-oj
liston	li-s-t-on
literatura	li-te-ra-tu-ra
literaturaj	li-te-ra-tu-r-aj
literaturo	li-te-ra-tu-ro
literaturon	li-te-ra-tu-r-on
literaturscienca	li-te-ra-tur-sci-en-ca
litero	li-te-ro
literoj	li-te-r-oj
lito	li-to
liton	li-t-on
litoto	li-to-to
liveri	li-ve-ri
liverpulo	li-ver-pu-lo
livido	li-vi-do
logi	lo-gi
logika	lo-gi-ka
logikaj	lo-gi-k-aj
logikan	lo-gi-k-an
logike	lo-gi-ke
logiko	lo-gi-ko
logŝnuro	log-ŝnu-ro
loĝanto	lo-ĝ-an-to
loĝejo	lo-ĝ-ejo
loĝi	lo-ĝi
lojala	lo-ja-la
loka	lo-ka
loko	lo-ko
lokomotivo	lo-ko-mo-ti-vo
lokomotivoj	lo-ko-mo-ti-v-oj
lokon	lo-k-on
longa	longa
longan	long-an
longdaŭra	long-daŭ-ra
longtempe	long-tem-pe
longe	longe
longega	long-ega
longitudo	lon-gi-tu-do
longorela	long-ore-la
loto	lo-to
lotumi	lo-t-umi
lotuso	lo-tu-so
luas	lu-as
lubriki	lu-bri-ki
lucido	lu-ci-do
ludado	lu-d-ado
ludas	lu-d-as
ludi	lu-di
ludis	lu-d-is
ludkartoj	lud-kar-t-oj
ludontaj	lu-d-ont-aj
ludos	lu-d-os
ludus	lu-d-us
luita	lu-ita
luko	lu-ko
lukso	luk-so
lukti	luk-ti
lukumo	lu-ku-mo
luli	lu-li
lulilo	lu-l-ilo
lulo	lu-lo
lumi	lu-mi
lumiĝas	lu-m-iĝ-as
lumis	lu-m-is
lumjaroj	lum-jar-oj
lumo	lu-mo
lumoj	lu-m-oj
lumoserĉantoj	lu-mo-ser-ĉ-an-t-oj
lumserĉantoj	lum-ser-ĉ-an-t-oj
lumturo	lum-tu-ro
luno	lu-no
lupo	lu-po
luprezo	lu-pre-zo
luteranismo	lu-te-ra-n-ismo
luterano	lu-te-ra-no
maĉgumon	maĉ-gum-on
maĉi	ma-ĉi
madrido	ma-dri-do
magazeno	ma-ga-ze-no
magazenon	ma-ga-ze-n-on
magistrato	ma-gi-strato
magnato	mag-na-to
magneto	mag-ne-to
magnetofonaj	mag-ne-to-fo-n-aj
magnetofone	mag-ne-to-fone
magra	magra
mahometo	ma-ho-meto
maizgrajnoj	ma-iz-graj-n-oj
maizo	ma-i-zo
majesta	ma-jes-ta
majo	ma-jo
majoritato	ma-jo-ri-ta-to
majskaraboj	maj-ska-ra-b-oj
majstro	majs-tro
majuskloj	ma-ju-s-kl-oj
Makbeto	mak-beto
maksimume	mak-si-m-ume
maksimumo	mak-si-m-umo
makulo	ma-ku-lo
malabrupta	mal-ab-rup-ta
maladekvata	mal-ade-kva-ta
malafabla	mal-afa-b-la
malagrabla	mal-agra-b-la
malakcepti	mal-ak-cep-ti
malakceptis	mal-ak-cep-t-is
malakito	mal-a-ki-to
malakra	mal-akra
malalta	mal-al-ta
malalte	mal-al-te
malaltigus	mal-al-t-ig-us
malami	mal-ami
malamikeco	mal-ami-k-eco
malamiko	mal-ami-ko
malamikoj	mal-ami-k-oj
malaminda	mal-am-inda
malamo	mal-amo
malantaŭ	mal-an-taŭ
malaperas	mal-ape-r-as
malaperi	mal-ape-ri
malaperinta	mal-ape-r-in-ta
malaperis	mal-ape-r-is
malavara	mal-ava-ra
malbela	mal-be-la
malbeni	mal-be-ni
malbona	mal-bona
malbonaĵoj	mal-bon-aĵ-oj
malbone	mal-bone
malboneco	mal-bon-eco
malbonigi	mal-bon-igi
malbonodoro	mal-bon-odo-ro
malbonon	mal-bon-on
maldekstra	mal-deks-tra
maldekstren	mal-deks-tren
maldelikate	mal-de-li-ka-te
maldika	mal-di-ka
maldikuleto	mal-di-ku-l-eto
maldiskreta	mal-di-s-k-reta
maldiskreti	mal-di-s-k-reti
maldolĉa	mal-dol-ĉa
male	male
maleolo	male-o-lo
malesperi	mal-es-pe-ri
malespero	mal-es-pe-ro
malestima	mal-es-ti-ma
malestimi	mal-es-ti-mi
malesto	mal-es-to
malfacilaj	mal-fa-ci-l-aj
malfacilaĵoj	mal-fa-ci-l-aĵ-oj
malfacilan	mal-fa-ci-l-an
malfacile	mal-fa-ci-le
malfacilecon	mal-fa-ci-l-ec-on
malfaciligita	mal-fa-ci-l-ig-ita
malfeliĉa	mal-fe-li-ĉa
malfeliĉe	mal-fe-li-ĉe
malfeliĉo	mal-fe-li-ĉo
malfermas	mal-ferm-as
malfermetas	mal-ferm-et-as
malfermi	mal-fermi
malfermis	mal-ferm-is
malfermita	mal-ferm-ita
malforta	mal-for-ta
malfortaj	mal-for-t-aj
malforte	mal-for-te
malfortigi	mal-for-t-igi
malfreŝa	mal-fre-ŝa
malfrue	mal-frue
malglato	mal-gla-to
malgranda	mal-granda
malgrandaj	mal-grand-aj
malgrandan	mal-grand-an
malgrandega	mal-grand-ega
malgrandigas	mal-grand-ig-as
malgrandigi	mal-grand-igi
malgrasulo	mal-gra-s-ulo
malgraŭ	mal-graŭ
malgrava	mal-gra-va
malĝentila	mal-ĝen-t-ila
malĝentilulino	mal-ĝen-ti-l-ul-ino
malĝoja	mal-ĝo-ja
malĝojan	mal-ĝo-j-an
malĝojeta	mal-ĝo-j-eta
malĝojon	mal-ĝo-j-on
malĝoju	mal-ĝo-ju
malĝusta	mal-ĝu-s-ta
malĝustaj	mal-ĝu-s-t-aj
malhelpi	mal-hel-pi
malhelpis	mal-hel-p-is
malhelpo	mal-hel-po
malhelpoj	mal-hel-p-oj
malhonesta	mal-ho-nes-ta
malhonoro	mal-ho-no-ro
malica	ma-li-ca
malinklino	mal-in-kli-no
maljuna	mal-juna
maljunulo	mal-jun-ulo
malkaraj	mal-kar-aj
malkaŝe	mal-ka-ŝe
malkaŝis	mal-ka-ŝ-is
malkaŝos	mal-ka-ŝ-os
malklaraĵo	mal-kla-r-aĵo
malklare	mal-kla-re
malklariĝi	mal-kla-r-iĝi
malkomforta	mal-kom-for-ta
malkomfortan	mal-kom-for-t-an
malkompreniĝoj	mal-kom-pre-n-iĝ-oj
malkonfesata	mal-kon-fe-s-ata
malkonfido	mal-kon-f-ido
malkonsentis	mal-kon-sen-t-is
malkontentigi	mal-kon-ten-t-igi
malkovri	mal-kov-ri
malkovris	mal-kov-ris
mallarĝa	mal-lar-ĝa
mallaŭte	mal-laŭ-te
malleviĝados	mal-le-v-iĝ-ad-os
mallibera	mal-li-be-ra
mallibereco	mal-li-be-r-eco
malliberejo	mal-li-be-r-ejo
malliberigis	mal-li-be-r-ig-is
mallongaj	mal-long-aj
mallongciklaj	mal-long-ci-kl-aj
mallongigo	mal-long-igo
mallongigoj	mal-long-ig-oj
malluma	mal-luma
mallumo	mal-lumo
malmola	mal-mo-la
malmultaj	mal-mul-t-aj
malmulte	mal-mul-te
malnete	mal-n-ete
malneto	mal-n-eto
malnobla	mal-no-b-la
malnoblulo	mal-no-bl-ulo
malnova	mal-nova
malnovaj	mal-nov-aj
malnovaĵo	mal-nov-aĵo
malnovan	mal-nov-an
malnovrita	mal-nov-rita
malo	malo
malofte	mal-of-te
maloportunan	mal-opor-tu-n-an
malperfektaj	mal-per-fek-t-aj
malpermesi	mal-per-me-si
malpermesis	mal-per-me-s-is
malpermesita	mal-per-me-s-ita
malpermesite	mal-per-me-s-ite
malplaĉo	mal-plaĉo
malplej	mal-plej
malplejaĝulo	mal-plej-aĝ-ulo
malplejan	mal-plej-an
malplena	mal-ple-na
malplenaĵo	mal-ple-n-aĵo
malplenkapulo	mal-plen-ka-p-ulo
malplenkapuloj	mal-plen-ka-p-ul-oj
malpli	mal-pli
malproksima	mal-prok-si-ma
malproksimaj	mal-prok-si-m-aj
malproksime	mal-prok-si-me
malprospera	mal-pro-s-pe-ra
malprosperaj	mal-pro-s-pe-r-aj
malpurigos	mal-pu-r-ig-os
malpuriĝi	mal-pu-r-iĝi
malrapide	mal-ra-pi-de
malregulaj	mal-re-gul-aj
malrekta	mal-rek-ta
malrekte	mal-rek-te
malriĉa	mal-ri-ĉa
malriĉaj	mal-ri-ĉ-aj
malsaĝa	mal-sa-ĝa
malsaĝaj	mal-sa-ĝ-aj
malsaĝaĵo	mal-sa-ĝ-aĵo
malsaĝaĵoj	mal-sa-ĝ-aĵ-oj
malsaĝe	mal-sa-ĝe
malsaĝeco	mal-sa-ĝ-eco
malsaĝiĝi	mal-sa-ĝ-iĝi
malsaĝulo	mal-sa-ĝ-ulo
malsaĝuloj	mal-sa-ĝ-ul-oj
malsama	mal-sa-ma
malsamaj	mal-sa-m-aj
malsaman	mal-sa-m-an
malsamlingvanaj	mal-sam-lin-g-va-n-aj
malsamas	mal-sam-as
malsana	mal-sa-na
malsanado	mal-sa-n-ado
malsanaj	mal-sa-n-aj
malsanema	mal-sa-n-ema
malsaneta	mal-sa-n-eta
malsani	mal-sa-ni
malsaniga	mal-sa-n-iga
malsaniĝi	mal-sa-n-iĝi
malsano	mal-sa-no
malsanulejo	mal-sa-n-ul-ejo
malsanulo	mal-sa-n-ulo
malsatas	mal-sa-t-as
malsato	mal-sato
malsaton	mal-sat-on
malsekeco	mal-se-k-eco
malsekiĝis	mal-se-k-iĝ-is
malserioza	mal-se-ri-o-za
malsobra	mal-so-bra
malsprita	mal-spri-ta
malstabila	mal-sta-bi-la
malsupre	mal-su-pre
malsupren	mal-su-pren
malsupreniri	mal-su-pren-iri
malŝatas	mal-ŝa-t-as
malŝati	mal-ŝa-ti
malŝatinda	mal-ŝa-t-inda
malŝaton	mal-ŝat-on
malŝpari	mal-ŝpa-ri
malŝtopi	mal-ŝto-pi
maltâga	mal-tâ-ga
maltrankvila	mal-trank-vi-la
maltrankvilaj	mal-trank-vi-l-aj
maltrankviliĝas	mal-trank-vi-l-iĝ-as
maltrankviliĝos	mal-trank-vi-l-iĝ-os
maltrankviliĝu	mal-trank-vi-l-iĝu
malutilaj	mal-uti-l-aj
malutili	mal-uti-li
malutilo	mal-uti-lo
malvarma	mal-varma
malvarme	mal-varme
malvarmeto	mal-varm-eto
malvarmumi	mal-varm-umi
malvarmumo	mal-varm-umo
malvasta	mal-va-s-ta
malvera	mal-ve-ra
malverekien	mal-ve-re-ki-en
malvirgigi	mal-virg-igi
malviva	mal-vi-va
malvo	mal-vo
mamo	ma-mo
mamoj	ma-m-oj
mamzono	mam-zo-no
mandato	man-da-to
manego	ma-n-ego
manĝaĵdonajn	man-ĝaĵ-do-n-ajn
manĝaĵon	man-ĝ-aĵ-on
manĝas	man-ĝ-as
manĝebla	man-ĝ-eb-la
manĝegemulino	man-ĝe-g-em-ul-ino
manĝi	man-ĝi
manĝilaro	man-ĝ-il-aro
manĝinda	man-ĝ-inda
manĝis	man-ĝ-is
manĝo	man-ĝo
manĝobruon	man-ĝo-bru-on
manĝoĉambro	man-ĝo-ĉam-bro
maniero	ma-ni-e-ro
manieron	ma-ni-e-r-on
manifestiĝi	ma-ni-fes-t-iĝi
manifestiĝo	ma-ni-fes-t-iĝo
maniko	ma-ni-ko
manipuli	ma-ni-pu-li
manipulo	ma-ni-pu-lo
maniuloj	ma-ni-ul-oj
manjo	ma-njo
mankas	man-k-as
manki	man-ki
mankis	man-k-is
mankoj	man-k-oj
mankon	man-k-on
mano	ma-no
manoj	ma-n-oj
manon	ma-n-on
manovri	ma-nov-ri
manplato	man-plato
mansvingo	man-svin-go
mantelo	man-te-lo
mantilo	man-ti-lo
manumo	ma-n-umo
manuskripto	ma-nu-s-krip-to
mapo	ma-po
marcipano	mar-ci-pa-no
marĉo	mar-ĉo
mardo	mar-do
margarito	mar-ga-ri-to
marinjo	ma-ri-njo
marioneto	ma-ri-o-ne-to
maristo	ma-r-isto
markis	mar-k-is
marko	mar-ko
markon	mar-k-on
markoto	mar-ko-to
marksisma	mark-s-isma
marksismaj	mark-s-ism-aj
marksismajn	mark-s-ism-ajn
marksisman	mark-s-ism-an
marksismoj	mark-s-ism-oj
marksismojn	mark-s-ism-ojn
marksismon	mark-s-ism-on
marmelado	mar-me-l-ado
marmito	mar-mi-to
marmoto	mar-mo-to
maro	maro
maron	mar-on
marono	ma-ro-no
maroto	ma-ro-to
marŝalo	mar-ŝa-lo
marŝi	mar-ŝi
marŝinta	mar-ŝin-ta
marŝiparo	mar-ŝip-aro
marŝjuĝisto?	mar-ŝju-ĝ-isto
marta	mar-ta
martami	mar-ta-mi
martelo	mar-te-lo
marto	mar-to
mary	ma-ry
maso	ma-so
masoni	ma-so-ni
masto	ma-s-to
mastodonto	ma-s-to-don-to
mastro	ma-s-tro
mastrumi	ma-s-tr-umi
maŝino	ma-ŝi-no
maŝinoj	ma-ŝi-n-oj
matematika	ma-te-ma-ti-ka
matematiko	ma-te-ma-ti-ko
matene	ma-tene
matenmanĝi	ma-ten-man-ĝi
mateno	ma-te-no
matenon	ma-te-n-on
materia	ma-te-ria
materialaj	ma-te-ri-al-aj
materialo	ma-te-ri-alo
materialoj	ma-te-ri-al-oj
materio	ma-te-rio
mato	mato
matraco	ma-tra-co
matrikulo	ma-tri-ku-lo
matura	ma-tu-ra
maturaĝa	ma-tu-ra-ĝa
maturaĝaj	ma-tu-ra-ĝ-aj
maturaĝulo	ma-tu-ra-ĝ-ulo
maturiĝinta	ma-tu-r-iĝ-in-ta
meblaro	me-b-l-aro
meblo	me-b-lo
mebloj	me-b-l-oj
mecenato	me-ce-na-to
meĉaĵo	me-ĉ-aĵo
medicino	me-di-ci-no
medikamento	me-di-ka-men-to
mediteraneo	me-di-te-ra-neo
mediti	me-di-ti
medito	me-di-to
megabiton	me-ga-bi-t-on
megalito	mega-li-to
meĥanikisto	me-ĥa-ni-k-isto
meĥaniko	me-ĥa-ni-ko
meĥanismo	me-ĥa-nis-mo
mekanika	me-ka-ni-ka
mekanikiston	me-ka-ni-k-ist-on
mekaniko	me-ka-ni-ko
mekanismo	me-ka-nis-mo
melki	mel-ki
melolonto	me-lo-lon-to
melono	me-lo-no
memadjunkta	mem-ad-junk-ta
memamo	mem-amo
memanalizo	mem-ana-li-zo
membrano	mem-bra-no
membro	mem-bro
membroj	mem-br-oj
memefiko	mem-efi-ko
memekscito	mem-eks-ci-to
memekzameno	mem-ek-za-me-no
memevidenta	mem-evi-den-ta
memfida	mem-fida
memindukto	mem-in-duk-to
meminstruito	mem-ins-tru-ito
memira	mem-ira
memkonscia	mem-kon-scia
memorado	me-mo-r-ado
memoras	me-mo-r-as
memori	me-mo-ri
memorigado	me-mo-r-ig-ado
memorigas	me-mo-r-ig-as
memorigu	me-mo-r-igu
memorinda	me-mo-r-inda
memoris	me-mo-r-is
memoro	me-mo-ro
memoron	me-mo-r-on
memoru	me-mo-ru
memserva	mem-ser-va
memstara	mem-sta-ra
memstare	mem-sta-re
memuaro	me-mu-aro
mencii	men-cii
menciiĝas	men-ci-iĝ-as
menciu	men-ciu
mendi	men-di
mendita	men-d-ita
meningo	me-nin-go
menslaboro	mens-la-bo-ro
menso	men-so
mensogado	men-so-g-ado
mensogi	men-so-gi
mentono	men-to-no
menuo	me-nuo
menuoj	me-nu-oj
mere	me-re
meringo	me-rin-go
meritantaj	me-ri-t-an-t-aj
meriti	me-ri-ti
merito	me-ri-to
meritoj	me-ri-t-oj
merkredo	mer-kre-do
mesaĝo	me-sa-ĝo
meslibro	mes-li-bro
metadis	me-t-ad-is
metado	me-t-ado
metaforan	me-ta-fo-r-an
metalfadeno	me-tal-fa-de-no
metalo	me-ta-lo
metalurgio	me-ta-lur-gio
metano	me-ta-no
metas	met-as
meti	meti
metiĝos	me-t-iĝ-os
metilo	me-ti-lo
metio	me-tio
metis	met-is
metita	me-t-ita
meto	meto
metodo	me-to-do
metro	me-tro
metu	metu
mezaj	mez-aj
mezalianco	meza-li-an-co
mezdistance	mez-di-s-tan-ce
meze	meze
mezembrio	me-zem-brio
mezentero	me-zen-te-ro
mezereo	me-ze-reo
mezgradaj	mez-gra-d-aj
mezgreka	mez-gre-ka
mezĵibo	mez-ĵi-bo
mezlernejo	mez-ler-n-ejo
meznombre	mez-nom-bre
mezo	mezo
mezonombro	mezo-nom-bro
meztage	mez-ta-ge
mezuras	me-zur-as
mezuri	me-zuri
mezurilo	me-zur-ilo
mezuro	me-zuro
mezuroj	me-zur-oj
mezurŝnuro	me-zur-ŝnu-ro
mezurunuoj	me-zur-unu-oj
miaj	miaj
mian	mian
miasmo	mi-a-smo
miaŭ	mi-aŭ
miĉjo	mi-ĉjo
mielo	mi-e-lo
mieno	mi-e-no
migdalarbo	mig-da-l-arbo
migri	mi-gri
miksi	mik-si
mikslingva	miks-lin-g-va
milda	mil-da
miliardo	mi-li-ar-do
miliardoj	mi-li-ar-d-oj
milimetro	mi-li-me-tro
miliono	mi-li-o-no
milionoj	mi-li-o-n-oj
militakiro	mi-lit-akiro
militi	mi-liti
militiroj	mi-lit-ir-oj
militistaj	mi-lit-ist-aj
militistaro	mi-lit-ist-aro
milito	mi-lito
militservis	mi-lit-ser-v-is
miljaro	mil-jaro
miljaroj	mil-jar-oj
miloj	mi-l-oj
milonojn	mi-l-on-ojn
milopoj	mi-l-op-oj
minacas	mi-na-c-as
minaci	mi-na-ci
mineralo	mi-ne-ra-lo
minimumo	mi-ni-m-umo
ministerio	mi-ni-s-te-rio
ministro	mi-ni-s-tro
mino	mi-no
minoritato	mi-no-ri-ta-to
minus	mi-n-us
minuskloj	mi-nu-s-kl-oj
minuto	mi-nu-to
minutoj	mi-nu-t-oj
minuton	mi-nu-t-on
miozoto	mi-o-zo-to
miras	mir-as
mire	mire
miregas	mire-g-as
mireginde	mire-g-inde
mirego	mire-go
miri	miri
mirigas	mir-ig-as
mirigos	mir-ig-os
mirinda	mir-inda
mirinde	mir-inde
mirtelo	mir-te-lo
misalo	mi-sa-lo
misciti	mis-ci-ti
misia	mi-sia
misie	mi-sie
misiisto	mi-si-isto
misilo	mi-silo
misio	mi-sio
misiuloj	mi-si-ul-oj
miskomprenis	mis-kom-pre-n-is
miskomprenon	mis-kom-pre-n-on
mislangulo	mis-lan-gu-lo
mislegi	mis-le-gi
mispaŝis	mis-pa-ŝ-is
mispensas	mis-pen-sas
mistera	mis-te-ra
misteraj	mis-te-r-aj
mistere	mis-te-re
mistero	mis-te-ro
mistifiki	mis-tifi-ki
misuzu	mis-uzu
mitingo	mi-tin-go
mito	mi-to
mizeran	mi-ze-r-an
mizero	mi-ze-ro
moda	mo-da
modaj	mo-d-aj
modelo	mo-de-lo
modelon	mo-de-l-on
modera	mo-de-ra
moderna	mo-der-na
modernaj	mo-der-n-aj
modesta	mo-des-ta
modeste	mo-des-te
modifado	mo-di-f-ado
modifadoj	mo-di-f-ad-oj
modifi	mo-di-fi
modifo	mo-di-fo
modifodecidoj	mo-di-fo-de-ci-d-oj
modifoj	mo-di-f-oj
modifus	mo-di-f-us
modo	mo-do
modoj	mo-d-oj
modon	mo-d-on
modulo	mo-du-lo
mokadi	mo-k-adi
mokado	mo-k-ado
mokados	mo-k-ad-os
mokanton	mo-kan-t-on
mokata	mo-k-ata
moki	mo-ki
mokistoj	mo-k-ist-oj
mokoj	mo-k-oj
mola	mo-la
molaĵo	mo-l-aĵo
molanaso	mo-la-na-so
molaro	mo-la-ro
molekulo	mo-le-ku-lo
molesti	mo-les-ti
momanto	mo-man-to
momento	mo-men-to
momenton	mo-men-t-on
monaĥo	mo-na-ĥo
monaj	mo-n-aj
monatnomoj	mo-nat-no-m-oj
monato	mo-na-to
monatoj	mo-na-t-oj
monda	mon-da
mondcivitanoj	mond-ci-vi-ta-n-oj
mondo	mon-do
monero	mo-ne-ro
moneroj	mo-ne-r-oj
mono	mo-no
monon	mo-n-on
monstro	mons-tro
monta	mon-ta
montaron	mon-t-ar-on
monteto	mon-t-eto
monto	mon-to
monton	mon-t-on
montradi	mon-tr-adi
montradis	mon-tr-ad-is
montras	mon-tr-as
montri	mon-tri
montriĝas	mon-tr-iĝ-as
montriĝis	mon-tr-iĝ-is
montriĝos	mon-tr-iĝ-os
montriĝus	mon-tr-iĝ-us
montris	mon-tr-is
montritaj	mon-tr-it-aj
montro	mon-tro
montros	mon-tr-os
monujo	mo-n-ujo
monumento	mo-nu-men-to
monumentoj	mo-nu-men-t-oj
morala	mo-ra-la
moralo	mo-ra-lo
morbido	mor-bi-do
mordeti	mor-d-eti
mordi	mor-di
morfemaro	mor-fe-m-aro
morfemo	mor-fe-mo
morgaŭ	mor-gaŭ
morgaŭa	mor-gaŭa
moro	mo-ro
morti	mor-ti
mortigi	mor-t-igi
mortigus	mor-t-ig-us
mortiĝi	mor-t-iĝi
mortinta	mor-t-in-ta
mortintaj	mor-t-in-t-aj
mortintan	mor-t-in-t-an
mortis	mor-t-is
morto	mor-to
mortos	mor-t-os
moseo	mo-seo
moskeo	mo-s-keo
moskito	mo-s-ki-to
moteto	mo-te-to
motivo	mo-ti-vo
motivoj	mo-ti-v-oj
motivon	mo-ti-v-on
moto	mo-to
motoro	mo-to-ro
motoron	mo-to-r-on
movadi	mo-v-adi
movi	mo-vi
moviĝu	mo-v-iĝu
movinta	mo-v-in-ta
movo	mo-vo
mucideco	mu-ci-d-eco
mueli	mu-e-li
muelradoj	mu-el-rad-oj
muĝi	mu-ĝi
mulato	mu-la-to
muller	mul-ler
mulo	mu-lo
multa	mul-ta
multaj	mul-t-aj
multe	mul-te
multego	mult-ego
multegon	mult-eg-on
multekosta	multe-ko-s-ta
multenombro	multe-nom-bro
multepromesaj	multe-pro-me-s-aj
multescia	multe-scia
multfoje	mult-foje
multipliki	mul-ti-pli-ki
multjara	mult-jara
multkoloraj	mult-ko-lo-r-aj
multo	mul-to
multoble	mult-ob-le
multon	mul-t-on
multrilate	mult-ri-la-te
multvalora	mult-va-lo-ra
multvorta	mult-vorta
mungi	mun-gi
munti	mun-ti
mureto	mu-reto
murmuri	mur-mu-ri
muro	mu-ro
murŝmiristo	mur-ŝmir-isto
muskato	mu-s-ka-to
musko	mu-s-ko
muskolo	mu-s-ko-lo
muskoloj	mu-s-ko-l-oj
muslina	mus-li-na
muso	mu-so
muŝo	mu-ŝo
muta	mu-ta
mutaj	mu-t-aj
mutila	muti-la
mutuloj	mu-t-ul-oj
muzelo	mu-ze-lo
muzeo	mu-zeo
muzikaj	mu-zi-k-aj
muzikistoj	mu-zi-k-ist-oj
muziko	mu-zi-ko
nacia	na-cia
naciaj	na-ci-aj
nacilingvaj	na-ci-lin-g-v-aj
nacio	na-cio
nacioj	na-ci-oj
nadlo	nad-lo
naĝi	na-ĝi
naiva	na-i-va
naivaj	na-i-v-aj
naiveco	na-i-v-eco
najbara	naj-bara
najbaran	naj-bar-an
najbaro	naj-baro
najbaroj	naj-bar-oj
najlo	naj-lo
najtingalo	naj-tin-ga-lo
napola	na-po-la
napoleono	na-po-le-o-no
narkoanalizo	nar-ko-ana-li-zo
narkoto	nar-ko-to
naski	na-s-ki
naskiĝantaj	na-s-k-iĝ-an-t-aj
naskiĝas	na-s-k-iĝ-as
naskiĝi	na-s-k-iĝi
naskiĝis	na-s-k-iĝ-is
naskiĝjaro	na-s-kiĝ-jaro
naskiĝo	na-s-k-iĝo
naskiĝos	na-s-k-iĝ-os
naskiĝtago	na-s-kiĝ-ta-go
natura	na-tu-ra
naturaj	na-tu-r-aj
naturan	na-tu-r-an
nature	na-tu-re
natureco	na-tu-r-eco
naturo	na-tu-ro
naturscienca	na-tur-sci-en-ca
naŭ	naŭ
naŭa	naŭa
naŭonoj	naŭ-on-oj
naŭope	naŭ-ope
naŭtilo	naŭ-ti-lo
naŭzi	naŭ-zi
navigo	na-vi-go
nazalnaze	na-zal-na-ze
nazo	na-zo
nazringo	naz-rin-go
nazsono	naz-so-no
naztruoj	naz-tru-oj
naztuko	naz-tu-ko
nazumo	na-z-umo
neadis	ne-ad-is
neakirebla	ne-akir-eb-la
neamatoroj	ne-ama-to-r-oj
neas	ne-as
neatingeble	ne-atin-g-eb-le
nebulo	ne-bu-lo
neces	ne-ces
necesa	ne-ce-sa
necesaj	ne-ce-s-aj
necese	ne-ce-se
neceseco	ne-ce-s-eco
necesejo	ne-ce-s-ejo
necesujo	ne-ce-s-ujo
necesus	ne-ce-s-us
nederlando	ne-der-lan-do
nedezirindeco	ne-de-zir-ind-eco
nediferencigeblaj	ne-di-fe-ren-c-ig-eb-l-aj
neebla	ne-eb-la
neeble	ne-eb-le
neebleco	ne-eb-l-eco
neekzistado	ne-ek-zi-s-t-ado
neeviteble	ne-evi-t-eb-le
nefaka	ne-fa-ka
nefermita	ne-ferm-ita
nefidinda	ne-fi-d-inda
neformala	ne-for-ma-la
neglekti	ne-glek-ti
negliĝo	ne-gli-ĝo
negrandaj	ne-grand-aj
negro	ne-gro
neĝblankaj	neĝ-blan-k-aj
neĝentila	ne-ĝen-t-ila
neĝisranda	ne-ĝis-ran-da
neĝo	ne-ĝo
neĝŝuoj	neĝ-ŝu-oj
neĝventego	neĝ-ven-t-ego
nehome	ne-ho-me
neimageble	ne-ima-g-eb-le
neinstruitaj	ne-ins-tru-it-aj
neklarigebla	ne-kla-r-ig-eb-la
nekleruloj	ne-kle-r-ul-oj
nekompareble	ne-kom-pa-r-eb-le
nekomprenado	ne-kom-pre-n-ado
nekomprenebla	ne-kom-pre-n-eb-la
nekompreneble	ne-kom-pre-n-eb-le
nekonata	ne-ko-n-ata
nekonatan	ne-ko-n-at-an
nekonato	ne-ko-n-ato
nekonscia	ne-kon-scia
nekonscie	ne-kon-scie
nekonsilinda	ne-kon-si-l-inda
nekredebla	ne-kre-d-eb-la
nekredeble	ne-kre-d-eb-le
nekredinda	ne-kre-d-inda
nelegeble	ne-le-g-eb-le
nelerta	ne-ler-ta
nelertecon	ne-ler-t-ec-on
neligitaj	ne-lig-it-aj
nelimigeblan	ne-li-m-ig-eb-l-an
nelonga	ne-longa
nelonge	ne-longe
nemalagrabla	ne-mal-agra-b-la
nemalbonaj	ne-mal-bon-aj
nemalhavebla	ne-mal-ha-v-eb-la
nemalkonfeseblaj	ne-mal-kon-fe-s-eb-l-aj
nematura	ne-ma-tu-ra
nemoveblaj	ne-mo-v-eb-l-aj
nemulte	nem-ul-te
nenia	nenia
neniaj	neni-aj
neniakvanta	nenia-kvan-ta
nenial	nenial
neniam	neniam
nenian	neni-an
nenie	nenie
neniel	neni-el
nenies	neni-es
neniigi	neni-igi
nenio	nenio
neniom	neni-om
nenion	neni-on
neniu	neniu
neniun	neni-un
neoficialaj	ne-ofi-ci-al-aj
neofito	ne-o-fi-to
neoportuna	ne-opor-tu-na
nepardoneble	ne-par-do-n-eb-le
nepensanta	ne-pen-san-ta
nepino	ne-pi-no
neplena	ne-ple-na
neplenumebla	ne-ple-nu-m-eb-la
nepo	ne-po
nepoj	ne-p-oj
nepra	ne-pra
nepre	ne-pre
nepripensita	ne-pri-pen-sita
neproduktiva	ne-pro-duk-ti-va
neproduktive	ne-pro-duk-ti-ve
neregulaj	ne-re-gul-aj
nerekomendinda	ne-re-ko-men-d-inda
nerekonebleco	ne-re-ko-n-eb-l-eco
nerekte	ne-rek-te
nervo	ner-vo
nervoza	ner-vo-za
nesaĝaj	ne-sa-ĝ-aj
nesana	ne-sa-na
nesciado	ne-sci-ado
nesciate	ne-sci-ate
nescienca	ne-sci-en-ca
neslaloma	ne-sla-lo-ma
neslava	ne-sla-va
neslovaka	ne-slo-va-ka
neslovena	ne-slo-ve-na
nesmeralda	ne-sme-ral-da
nesolvita	ne-sol-v-ita
nesto	nes-to
nesufiĉa	ne-su-fi-ĉa
netaŭgeco	ne-taŭ-g-eco
neto	ne-to
nêtralaj	nê-tra-l-aj
neŭtrala	neŭ-tra-la
neŭtralan	neŭ-tra-l-an
neŭtraleco	neŭ-tra-l-eco
neŭtralsignifa	neŭ-tral-sig-ni-fa
nevalida	ne-va-li-da
nevino	ne-vi-no
nevo	ne-vo
niaepoke	nia-epo-ke
niaj	niaj
nialanda	nia-lan-da
nian	nian
niĉjo	ni-ĉjo
nigra	ni-gra
nigraj	ni-gr-aj
nikĉjo	nik-ĉjo
nikoĉjo	ni-ko-ĉjo
nikolĉjo	ni-kol-ĉjo
nilono	ni-lo-no
nirvano	nir-va-no
Nitzsche	nitz-sche
nivelo	ni-ve-lo
nobla	no-b-la
nocio	no-cio
nocioj	no-ci-oj
nodo	no-do
nokte	nok-te
noktiĝos	nok-t-iĝ-os
nokto	nok-to
nokton	nok-t-on
nomas	no-m-as
nomata	no-m-ata
nomataj	no-m-at-aj
nombrado	nom-br-ado
nombras	nom-br-as
nombri	nom-bri
nombro	nom-bro
nombron	nom-br-on
nome	no-me
nomi	no-mi
nomitaj	no-m-it-aj
nomo	no-mo
nomoj	no-m-oj
nomon	no-m-on
nomos	no-m-os
nomovorto	no-mo-vorto
nomus	no-m-us
norda	norda
nordafrika	nord-af-ri-ka
nordafrikajn	nord-af-ri-k-ajn
nordamerika	nord-ame-ri-ka
nordamerikaj	nord-ame-ri-k-aj
nordaŭstraliaj	nord-aŭ-s-tra-li-aj
nordaziaj	nord-azi-aj
nordeŭropa	nord-eŭ-ro-pa
nordgermania	nord-ger-ma-nia
nordlumo	nord-lumo
nordo	nordo
nordrusia	nord-ru-sia
normala	nor-ma-la
normalan	nor-ma-l-an
normale	nor-ma-le
norvego	nor-ve-go
notas	no-t-as
noti	no-ti
notinde	no-t-inde
notitaj	no-t-it-aj
notlibron	not-li-br-on
noto	no-to
notoj	no-t-oj
notos	no-t-os
notu	no-tu
nova	nova
novaj	nov-aj
novaĵo	nov-aĵo
novaliĝinta	noval-iĝ-in-ta
novan	nov-an
nove	nove
novedzinon	nov-edzi-n-on
novembro	novem-bro
novjorkano	nov-jor-ka-no
novulo	nov-ulo
nuance	nu-an-ce
nuanco	nu-an-co
nuancoj	nu-an-c-oj
nubbazo	nub-ba-zo
nubo	nu-bo
nuda	nu-da
nuddenta	nud-den-ta
nuko	nu-ko
nukso	nuk-so
nuksrompilo	nuks-rom-p-ilo
nula	nu-la
nulo	nu-lo
numeraloj	nu-me-ra-l-oj
numero	nu-me-ro
numeroj	nu-me-r-oj
numeron	nu-me-r-on
numerplato	nu-mer-plato
nuna	nu-na
nunaj	nu-n-aj
nunaĵon	nu-n-aĵ-on
nuntempaj	nun-tem-p-aj
nutraĵgreno	nu-traĵ-gre-no
nutri	nu-tri
obeante	obe-an-te
obei	obei
obeu	obeu
objekto	ob-jek-to
objektoj	ob-jek-t-oj
obleco	ob-l-eco
oblikva	ob-li-k-va
observas	ob-ser-v-as
observejo	ob-ser-v-ejo
observemo	ob-ser-v-emo
observendan	ob-ser-ven-d-an
observi	ob-ser-vi
observu	ob-ser-vu
obskura	ob-sku-ra
obstaklo	ob-sta-klo
obstina	ob-sti-na
obstinaj	ob-sti-n-aj
obstine	ob-stine
obstinecon	ob-sti-n-ec-on
oceano	oce-ano
odeson	ode-s-on
odori	odo-ri
ofald	ofald
ofendi	ofen-di
oferante	ofe-r-an-te
ofere	ofe-re
oferi	ofe-ri
oferitaj	ofe-r-it-aj
oferoj	ofe-r-oj
oferon	ofe-r-on
oferti	ofer-ti
ofic	ofic
oficejo	ofi-c-ejo
oficiala	ofi-ci-ala
oficialaj	ofi-ci-al-aj
oficialaĵo	ofi-ci-al-aĵo
oficialan	ofi-ci-al-an
oficialeco	ofi-ci-al-eco
oficialigi	ofi-ci-aligi
oficialigita	ofi-ci-alig-ita
oficialigo	ofi-ci-aligo
oficiro	ofi-ciro
oficisto	ofi-c-isto
ofico	ofi-co
ofta	of-ta
oftaĝ	of-taĝ
oftaj	of-t-aj
oftan	of-t-an
ofte	of-te
ofteca	of-t-eca
oftecaj	of-t-ec-aj
ofteco	of-t-eco
oftecogrupoj	of-te-co-gru-p-oj
oftecoliston	of-te-co-l-ist-on
oftecon	of-t-ec-on
ojstro	ojs-tro
okazaj	oka-z-aj
okazaĵo	oka-z-aĵo
okazaĵoj	oka-z-aĵ-oj
okazas	oka-z-as
okaze	oka-ze
okazi	oka-zi
okazis	oka-z-is
okazo	oka-zo
okazoj	oka-z-oj
okazon	oka-z-on
okazos	oka-z-os
okcidenta	ok-ci-denta
okcidentafrikajn	ok-ci-dent-af-ri-k-ajn
okcidentamerikaj	ok-ci-dent-ame-ri-k-aj
okcidentaŭstraliaj	ok-ci-dent-aŭ-s-tra-li-aj
okcidentaziaj	ok-ci-dent-a-zi-aj
okcidenten	ok-ci-dent-en
okcidenteŭropa	ok-ci-dent-eŭ-ro-pa
okcidentgermania	ok-ci-dent-ger-ma-nia
okcidento	ok-ci-dento
okcidentslava	ok-ci-dent-sla-va
okcipito	ok-ci-pi-to
okonajn	ok-on-ajn
okonfolia	ok-on-fo-lia
okonnoto	ok-on-no-to
okonon	ok-on-on
okopajn	ok-op-ajn
okope	ok-ope
okopo	ok-opo
oksido	ok-si-do
oktanto	ok-tan-to
oktobro	ok-to-bro
okulario	oku-la-rio
okulharo	okul-haro
okulo	oku-lo
okuloj	oku-l-oj
okulon	oku-l-on
okulvideblan	okul-vi-d-eb-l-an
okulvideble	okul-vi-d-eb-le
okulvitroj	okul-vi-tr-oj
okupadi	oku-p-adi
okupadis	oku-p-ad-is
okupas	oku-p-as
okupi	oku-pi
okupiĝi	oku-p-iĝi
okupos	oku-p-os
okupus	oku-p-us
oleo	oleo
olivĝardenojn	oliv-ĝar-de-n-ojn
olivo	oli-vo
omaron	oma-r-on
ombrelo	om-bre-lo
ombro	om-bro
omego	ome-go
omleto	om-le-to
onano	ona-no
ondo	on-do
onklino	on-kli-no
onklo	on-klo
opas	op-as
operacii	ope-ra-cii
operacio	ope-ra-cio
operacion	ope-ra-ci-on
opero	ope-ro
opidumo	opi-du-mo
opiniadi	opi-ni-adi
opinias	opi-ni-as
opinii	opi-nii
opiniis	opi-ni-is
opinio	opi-nio
opinioj	opi-ni-oj
oponi	opo-ni
opono	opo-no
oportunaĵoj	opor-tu-n-aĵ-oj
oportunan	opor-tu-n-an
oportune	opor-tune
oposumo	opo-su-mo
opozicii	opo-zi-cii
oral	oral
oranĝĝardenoj	oranĝ-ĝar-de-n-oj
oranĝo	oran-ĝo
oranĝon	oran-ĝ-on
oratoro	ora-to-ro
orbito	or-bi-to
ordiga	or-d-iga
ordigitaj	or-d-ig-it-aj
ordinaraj	or-di-na-r-aj
ordinare	or-di-na-re
ordinaro	or-di-na-ro
ordinato	or-di-na-to
ordo	or-do
ordona	or-do-na
ordonaj	or-do-n-aj
ordonanta	or-do-n-an-ta
ordoni	or-do-ni
ordono	or-do-no
orelo	ore-lo
orelon	ore-l-on
orfdomo	orf-do-mo
orfo	or-fo
organa	or-ga-na
organismo	or-ga-n-ismo
organizi	or-ga-ni-zi
organizis	or-ga-ni-z-is
organizsistemon	or-ga-niz-si-s-te-m-on
organo	or-ga-no
organoj	or-ga-n-oj
orientafrikajn	ori-ent-af-ri-k-ajn
orientamerikaj	ori-ent-ame-ri-k-aj
orientaŭstraliaj	ori-ent-aŭ-s-tra-li-aj
orientaziaj	ori-ent-azi-aj
orienteŭropa	ori-ent-eŭ-ro-pa
orientgermania	ori-ent-ger-ma-nia
orienti	ori-enti
oriento	ori-ento
orientslava	ori-ent-sla-va
origina	ori-gi-na
originaj	ori-gi-n-aj
originala	ori-gi-na-la
originalaj	ori-gi-na-l-aj
originalaĵoj	ori-gi-na-l-aĵ-oj
originalo	ori-gi-na-lo
origino	ori-gi-no
orkestro	or-ke-s-tro
ornami	or-na-mi
ortangulo	ortan-gu-lo
orthoepy	or-tho-e-py
orto	orto
ortodoksuloj	orto-dok-s-ul-oj
ortografian	orto-gra-fi-an
ortografio	orto-gra-fio
ortografion	orto-gra-fi-on
ortorelo	orto-re-lo
oscedi	os-ce-di
oscili	os-ci-li
oscilo	os-ci-lo
osto	os-to
ovaĵo	ov-aĵo
ovalo	ova-lo
ovblanko	ov-blan-ko
ovujo	ov-ujo
pacgardistoj	pac-gar-d-ist-oj
pacienca	pa-ci-en-ca
pacience	pa-ci-en-ce
pacienco	pa-ci-en-co
paciencon	pa-ci-en-c-on
pacifiko	pa-cifi-ko
paco	pa-co
paĉjo	pa-ĉjo
paĉulo	pa-ĉu-lo
paduso	pa-du-so
pafado	pa-f-ado
pafbruon	paf-bru-on
pafcelojn	paf-ce-l-ojn
pafi	pa-fi
pafilego	pa-fi-le-go
pafilo	pa-f-ilo
pafĵetis	paf-ĵe-t-is
pafmortigita	paf-mor-t-ig-ita
pagata	pa-g-ata
pagi	pa-gi
pagipovaj	pa-gi-po-v-aj
pagis	pa-g-is
pago	pa-go
paĝo	pa-ĝo
paĝocento	pa-ĝo-cen-to
paĝoj	pa-ĝ-oj
paĝonumero	pa-ĝo-nu-me-ro
pajlo	paj-lo
pakaĵo	pa-k-aĵo
pakaĵon	pa-k-aĵ-on
paketon	pa-k-et-on
paki	pa-ki
pako	pa-ko
pakon	pa-k-on
pala	pa-la
palaco	pa-la-co
palato	pa-la-to
palestro	pa-le-s-tro
paliĝi	pal-iĝi
paliĝis	pal-iĝ-is
paliĝos	pal-iĝ-os
paliso	pa-li-so
palmo	pal-mo
palmolea?	pal-m-olea
palpebro	pal-pe-bro
palpebrumi	pal-pe-br-umi
palpi	pal-pi
palpito	pal-pi-to
palto	pal-to
pamfleto	pam-fle-to
panarbo?	pa-n-arbo
paneas	pa-ne-as
panejon	pa-n-ej-on
paneo	pa-neo
panja	pa-nja
panjaj	pa-nj-aj
panjajn	pa-nj-ajn
panjan	pa-nj-an
panje	pa-nje
panjo	pa-njo
panjoj	pa-nj-oj
panjojn	pa-nj-ojn
panjon	pa-nj-on
pano	pa-no
panon	pa-n-on
panpeco	pan-pe-co
pantalono	pan-ta-lo-no
pantoflo	pan-to-flo
papago	pa-pa-go
papera	pa-pe-ra
paperan	pa-pe-r-an
papero	pa-pe-ro
paperon	pa-pe-r-on
paperŝmiri	pa-per-ŝmiri
paperujo	pa-pe-r-ujo
papilio	pa-pi-lio
papo	pa-po
paradizo	pa-ra-di-zo
paralele	pa-ra-le-le
paralelo	pa-ra-le-lo
paraŝuto	pa-ra-ŝu-to
parazito	pa-ra-zi-to
pardonas	par-do-n-as
pardonema	par-do-n-ema
pardoni	par-do-ni
pardonu	par-do-nu
parenco	pa-ren-co
parfumo	par-fu-mo
pargeto	par-ge-to
parizano	pa-ri-za-no
parizo	pa-ri-zo
parko	par-ko
parlamento	par-la-men-to
paro	paro
paroĥo	pa-ro-ĥo
paroĥpregejo	pa-roĥ-pre-g-ejo
paroladas	pa-rol-ad-as
parolado	pa-rol-ado
paroladon	pa-rol-ad-on
parolados	pa-rol-ad-os
parolantaj	pa-rol-an-t-aj
parolante	pa-rol-an-te
parolanto	pa-rol-an-to
parolas	pa-rol-as
parolata	pa-rol-ata
parolelementoj	pa-rol-ele-ment-oj
parolema	pa-rol-ema
paroli	pa-roli
paroligi	pa-rol-igi
paroligos	pa-rol-ig-os
parolis	pa-rol-is
parolo	pa-rolo
paroloj	pa-rol-oj
parolos	pa-rol-os
parolu	pa-rolu
parolus	pa-rol-us
paron	par-on
parte	par-te
participoj	par-ti-ci-p-oj
participsufiksoj	par-ti-cip-su-fik-s-oj
partikulara	par-ti-ku-la-ra
partikularo	par-ti-ku-la-ro
partikulo	par-ti-ku-lo
partio	par-tio
partizano	par-ti-za-no
partlaboro	part-la-bo-ro
parto	par-to
partoj	par-t-oj
parton	par-t-on
partopreni	par-to-pre-ni
pasado	pas-ado
pasaĝero	pasa-ĝe-ro
pasamentisto	pasa-men-t-isto
pasas	pas-as
pasero	pa-se-ro
pasi	pasi
pasinta	pas-in-ta
pasintajn	pas-in-t-ajn
pasintojn	pas-in-t-ojn
pasinton	pas-in-t-on
pasio	pasio
pasis	pas-is
pasko	pas-ko
paskvilo	pas-k-vi-lo
pasloĝi	pas-lo-ĝi
pasos	pas-os
pasporto	pas-por-to
pasrajto	pas-raj-to
pasto	pas-to
pastoro	pas-to-ro
pastro	pas-tro
paŝas	paŝ-as
paŝi	paŝi
paŝis	paŝ-is
paŝmaniero	paŝ-ma-ni-e-ro
paŝmezuri	paŝ-me-zuri
paŝoj	paŝ-oj
paŝon	paŝ-on
paŝpremo	paŝ-pre-mo
paŝŝanĝi	paŝ-ŝan-ĝi
paŝtela	paŝ-te-la
paŝti	paŝ-ti
pato	pato
patra	pa-tra
patraj	pa-tr-aj
patran	pa-tr-an
patrineto	pa-tri-n-eto
patrino	pa-tri-no
patriota	pa-tri-o-ta
patriotismo	pa-tri-o-t-ismo
patro	pa-tro
patroj	pa-tr-oj
patron	pa-tr-on
patrono	pa-tro-no
patrujo	pa-tr-ujo
paŭlino	paŭ-li-no
paŭzi	paŭ-zi
paŭzon	paŭ-z-on
pavo	pa-vo
pazigrafioj	pa-zi-gra-fi-oj
peca	pe-ca
peceto	pe-c-eto
peco	pe-co
pecoj	pe-c-oj
pecon	pe-c-on
pedagogia	pe-da-go-gia
pedagogiaj	pe-da-go-gi-aj
pedagogoj	pe-da-go-g-oj
pedanto	pe-dan-to
pedikularo	pe-di-ku-laro
pejzaĝo	pej-za-ĝo
peki	pe-ki
pekli	pe-kli
pelasgo	pe-las-go
peli	pe-li
pelikano	pe-li-ka-no
pelto	pel-to
penadis	pe-n-ad-is
penante	pe-n-an-te
penas	pe-n-as
pendi	pen-di
pendigi	pen-d-igi
pendolo	pen-do-lo
penetri	pe-ne-tri
peni	pe-ni
peniko	pe-ni-ko
penos	pe-n-os
pensadi	pen-sadi
pensadis	pen-sad-is
pensado	pen-sado
pensanta	pen-san-ta
pensantaj	pen-san-t-aj
pensante	pen-san-te
pensas	pen-sas
pense	pen-se
pensema	pen-sema
pensi	pen-si
pensio	pen-sio
pensis	pen-sis
penso	pen-so
pensoj	pen-soj
penson	pen-son
pensu	pen-su
penti	pen-ti
pentraĵo	pen-tr-aĵo
pentras	pen-tr-as
pentri	pen-tri
perdas	per-d-as
perdi	per-di
perdiĝas	per-d-iĝ-as
perdiĝos	per-d-iĝ-os
perdis	per-d-is
perdita	per-d-ita
perdos	per-d-os
perdu	per-du
perdus	per-d-us
pere	pe-re
perei	pe-rei
pereigi	pe-re-igi
pereos	pe-re-os
pereus	pe-re-us
perfekta	per-fek-ta
perfektaj	per-fek-t-aj
perfektan	per-fek-t-an
perfekte	per-fek-te
perfekteco	per-fek-t-eco
perfektigado	per-fek-t-ig-ado
perfektigo	per-fek-t-igo
perfektiĝado	per-fek-t-iĝ-ado
perfektiĝados	per-fek-t-iĝ-ad-os
perfekto	per-fek-to
perfidi	per-fi-di
perfido	per-fi-do
perforte	per-for-te
periodo	pe-ri-o-do
perko	per-ko
perlabori	per-la-bo-ri
perlamoto	per-la-mo-to
perlo	per-lo
permesantaj	per-me-s-an-t-aj
permesas	per-me-s-as
permesi	per-me-si
permesita	per-me-s-ita
permeson	per-me-s-on
perono	pe-ro-no
persekutado	per-se-ku-t-ado
persekuti	per-se-ku-ti
persekutis	per-se-ku-t-is
persiko	per-si-ko
persisti	per-si-s-ti
persisto	per-si-s-to
persono	per-so-no
personoj	per-so-n-oj
personon	per-so-n-on
persvado	per-sva-do
pesi	pe-si
pesilo	pe-s-ilo
pesticido	pes-ti-ci-do
petado	pe-t-ado
petas	pet-as
petegas	pe-t-eg-as
petegi	pe-t-egi
petegis	pe-t-eg-is
peterburgon	pe-ter-burg-on
peti	peti
petis	pet-is
peto	peto
petoli	pe-to-li
petos	pet-os
petro	pe-tro
petrolo	pe-tro-lo
peza	pe-za
pezaj	pe-z-aj
peze	pe-ze
pezi	pe-zi
pezilo	pe-z-ilo
pezmove	pez-mo-ve
pezon	pe-z-on
pfenigo	pfe-ni-go
piano	pi-ano
piceo	pi-ceo
piecjustecstilo	pi-ec-ju-s-tec-st-ilo
piedbatante	pi-ed-ba-t-an-te
piede	pi-e-de
piedego	pi-e-d-ego
piedingo	pi-ed-in-go
piediris	pi-e-dir-is
piednotoj	pi-ed-no-t-oj
piednoton	pi-ed-no-t-on
piedo	pi-e-do
piedoj	pi-e-d-oj
pieroto	pi-e-ro-to
pigo	pi-go
piki	pi-ki
pikilo	pi-k-ilo
piko	pi-ko
pikoj	pi-k-oj
pilko	pil-ko
pilo	pilo
piloto	pi-lo-to
pinĉi	pin-ĉi
pinĉkvanton	pinĉ-kvan-t-on
pindo	pin-do
pinglo	pin-glo
pino	pi-no
pinta	pinta
pinto	pinto
pintorela	pint-ore-la
pioĉo	pi-o-ĉo
pioniro	pi-o-niro
pioniroj	pi-o-nir-oj
pipo	pi-po
pipro	pi-pro
piramido	pi-ra-mido
piranjo	pira-njo
pirato	pi-ra-to
pirito	pi-ri-to
piro	piro
piron	pir-on
pisto	pi-s-to
pitecio	pi-te-cio
pivoto	pi-vo-to
pizĝardenon	piz-ĝar-de-n-on
pizo	pi-zo
placo	pla-co
plaĉa	plaĉa
plaĉas	pla-ĉ-as
plaĉe	plaĉe
plaĉi	pla-ĉi
plaĉis	pla-ĉ-is
plado	plado
plafono	pla-fo-no
plago	pla-go
plaĝo	pla-ĝo
planas	pla-n-as
plando	plan-do
plandumo	plan-d-umo
planedo	pla-ne-do
planis	pla-n-is
planko	plan-ko
plano	pla-no
planon	pla-n-on
planto	plan-to
plantpatologo	plant-pa-to-lo-go
plastiko	pla-s-ti-ko
plasto	pla-s-to
plata	plata
platano	pla-ta-no
plateno	pla-te-no
platformo	plat-for-mo
platino	pla-ti-no
plebiscito	ple-bi-sci-to
plej	plej
plejaĝulo	plej-aĝ-ulo
pleje	pleje
plekti	plek-ti
plena	plena
plenaĝa	plen-a-ĝa
plenaj	plen-aj
plenan	plen-an
plenda	plen-da
plendas	plen-d-as
plendi	plen-di
plene	plene
pleneca	plen-eca
pleneco	plen-eco
plenigita	plen-ig-ita
plenigitaj	plen-ig-it-aj
plenplena	plen-ple-na
plenŝvelinta	plen-ŝve-l-in-ta
plenumadi	plen-u-m-adi
plenumadis	plen-u-m-ad-is
plenumas	plen-um-as
plenumeblaj	plen-u-m-eb-l-aj
plenumi	plen-umi
plenumiĝinta	plen-u-m-iĝ-in-ta
plenumo	plen-umo
pleonasma	ple-o-nas-ma
pleto	ple-to
plezure	ple-zu-re
plezuro	ple-zu-ro
plia	plia
pliaj	pli-aj
plian	pli-an
plibonaĵoj	pli-bo-n-aĵ-oj
pliboneco	pli-bo-n-eco
plibonecon	pli-bo-n-ec-on
plibonigi	pli-bo-n-igi
plibonigoj	pli-bo-n-ig-oj
plie	plie
plifortiĝas	pli-for-t-iĝ-as
pligrandigo	pli-grand-igo
pliigi	pli-igi
plilarĝigo	pli-la-r-ĝ-igo
plimulte	pli-mul-te
plimulto	pli-mul-to
plimulton	pli-mul-t-on
plinto	plin-to
plivolante	pli-vo-l-an-te
plonĝi	plon-ĝi
plorema	plo-r-ema
plori	plo-ri
plorigos	plo-r-ig-os
ploris	plo-r-is
ploros	plo-r-os
ploto	plo-to
pluan	plu-an
plugĉevaloj	plug-ĉe-va-l-oj
plugi	plu-gi
plugilo	plu-g-ilo
plumbo	plum-bo
plumĉapo	plum-ĉa-po
plumeraro	plum-era-ro
plumingo	plu-m-ingo
plumknaro	plum-knaro
plumo	plu-mo
plumon	plu-m-on
plumujo	plu-m-ujo
pluraj	plu-r-aj
pluralo	plu-ra-lo
plurfoja	plur-foja
plurfoje	plur-foje
plus	plus
pluslaboro	plu-sla-bo-ro
pluŝbesto	pluŝ-bes-to
pluvego	plu-v-ego
pluvglacio	pluv-gla-cio
pluvo	plu-vo
poemo	po-e-mo
poemon	po-e-m-on
poeto	po-e-to
poezio	po-e-zio
pola	po-la
polaro	po-la-ro
policano	po-li-ca-no
policanola	po-li-ca-no-la
policanon	po-li-ca-n-on
policestro	po-li-c-es-tro
polico	po-li-co
policon	po-li-c-on
policservoj	po-lic-ser-v-oj
poligloto	po-li-glo-to
politikaj	po-li-ti-k-aj
politiko	po-li-ti-ko
polo	po-lo
poluro	po-lu-ro
polvero	pol-ve-ro
polvo	pol-vo
polovcaj	po-lov-c-aj
pomado	po-ma-do
pomarbo	pom-arbo
pomo	po-mo
pomon	po-m-on
pomŝirantaj	pom-ŝir-an-t-aj
pomujo	po-m-ujo
ponardego	po-nar-d-ego
ponto	pon-to
popolamaso	po-po-l-ama-so
popolĝojo	po-pol-ĝo-jo
popolo	po-po-lo
popolon	po-po-l-on
populara	po-pu-la-ra
popularigi	po-pu-la-r-igi
popularscienca	po-pu-lar-sci-en-ca
porcelano	por-ce-la-no
porcio	por-cio
pordego	por-d-ego
pordhoko	pord-ho-ko
pordo	por-do
pordon	por-d-on
porko	por-ko
poro	poro
portante	por-t-an-te
porti	por-ti
portis	por-t-is
portreto	por-tre-to
posedado	po-se-d-ado
posedanta	po-se-d-an-ta
posedantaj	po-se-d-an-t-aj
posedas	po-se-d-as
posedi	po-se-di
posedis	po-se-d-is
posedos	po-se-d-os
posedus	po-se-d-us
post	post
postaj	post-aj
postaĵtruon	post-aĵ-tru-on
postamento	pos-ta-men-to
poste	poste
posteno	pos-teno
postesignoj	poste-sig-n-oj
posteniĝis	pos-ten-iĝ-is
posteuloj	poste-ul-oj
postfaran	post-fa-r-an
postfinaj	post-fi-n-aj
postiljono	pos-til-jo-no
postĵetis	post-ĵe-t-is
postmorgaŭ	post-mor-gaŭ
postsigno	post-sig-no
postulantaj	pos-tu-l-an-t-aj
postulas	pos-tu-l-as
postulataj	pos-tu-l-at-aj
postuli	pos-tu-li
postulis	pos-tu-l-is
postuloj	pos-tu-l-oj
postulus	pos-tu-l-us
poŝformata	poŝ-for-ma-ta
poŝhorloĝo	poŝ-hor-lo-ĝo
poŝmono	poŝ-mo-no
poŝo	poŝo
poŝŝteli	poŝ-ŝte-li
poŝta	poŝta
poŝtaĵoj	poŝt-aĵ-oj
poŝtcenzuro	poŝt-cen-zu-ro
poŝtelefono	poŝ-te-le-fo-no
poŝtelspezoj	poŝt-el-spe-z-oj
poŝtestro	poŝt-es-tro
poŝtisto	poŝt-isto
poŝtkarto	poŝt-kar-to
poŝtkesto	poŝt-kes-to
poŝtkodo	poŝt-ko-do
poŝtmandato	poŝt-man-d-ato
poŝtmarko	poŝt-mar-ko
poŝto	poŝto
poŝtoficejo	poŝt-ofi-c-ejo
poŝtranĉilo	poŝ-tran-ĉ-ilo
poŝtrestante	poŝt-res-t-an-te
poŝtsako	poŝt-sa-ko
poŝtuko	poŝ-tu-ko
poŝtveturigisto	poŝt-ve-tu-ri-g-isto
poŝvortaro	poŝ-vort-aro
potence	po-ten-ce
potenco	po-ten-co
poto	po-to
povadon	po-v-ad-on
povanta	po-v-an-ta
povantaj	po-v-an-t-aj
povas	po-v-as
povi	po-vi
povis	po-v-is
povoj	po-v-oj
povon	po-v-on
povos	po-v-os
povoscii	po-vo-scii
povu	po-vu
povus	po-v-us
pozicio	po-zi-cio
pozicion	po-zi-ci-on
pozitivaj	po-zi-ti-v-aj
pozitive	po-zi-ti-ve
pragmatisme	prag-ma-t-isme
praktika	prak-ti-ka
praktikaj	prak-ti-k-aj
praktikan	prak-ti-k-an
praktike	prak-ti-ke
praktiko	prak-ti-ko
pranepo	pra-ne-po
prapraavoj	pra-pra-av-oj
prava	pra-va
pravas	pra-v-as
prave	pra-ve
pravigas	pra-v-ig-as
pravigita	pra-v-ig-ita
pravis	pra-v-is
precipa	pre-ci-pa
Preben	preben
precipe	pre-ci-pe
precipito	pre-ci-pi-to
preciza	pre-ci-za
precizaj	pre-ci-z-aj
precizan	pre-ci-z-an
precize	pre-ci-ze
precizeco	pre-ci-z-eco
precizigita	pre-ci-z-ig-ita
prefekto	pre-fek-to
preferas	pre-fe-r-as
prefere	pre-fe-re
preferi	pre-fe-ri
prefero	pre-fe-ro
preferos	pre-fe-r-os
preferus	pre-fe-r-us
prefikso	pre-fik-so
prefiksoj	pre-fik-s-oj
prefikson	pre-fik-s-on
preĝejo	pre-ĝ-ejo
preĝi	pre-ĝi
prelato	pre-la-to
prelegi	pre-le-gi
premado	pre-m-ado
premi	pre-mi
premio	pre-mio
prenanto	pre-n-an-to
prenas	pre-n-as
preni	pre-ni
prenilo	pre-n-ilo
preninte	pre-n-in-te
prenis	pre-n-is
prenitaj	pre-n-it-aj
prenos	pre-n-os
prenu	pre-nu
prenus	pre-n-us
prepari	pre-pa-ri
preparis	pre-pa-r-is
preparlaboroj	pre-par-la-bo-r-oj
preparo	pre-pa-ro
prepozicio	pre-po-zi-cio
prepozicioj	pre-po-zi-ci-oj
preseraro	pres-era-ro
presi	pre-si
presigis	pre-s-ig-is
presita	pre-s-ita
preskaŭ	pre-s-kaŭ
preskaŭsinonimo	pre-s-kaŭ-si-no-ni-mo
preskribi	pre-skri-bi
preskriboj	pre-skri-b-oj
preslitero	pres-li-te-ro
prespretajn	pres-pret-ajn
prestidigito	pres-ti-di-gi-to
prestiĝo	pres-ti-ĝo
preta	preta
pretaj	pret-aj
pretan	pret-an
preteksto	pre-tek-s-to
pretekstoj	pre-tek-s-t-oj
pretendas	pre-ten-d-as
pretendi	pre-ten-di
preter	pre-ter
preteratenti	pre-ter-a-ten-ti
preterito	pre-teri-to
prezentantaj	pre-zen-t-an-t-aj
prezentas	pre-zen-t-as
prezenti	pre-zen-ti
prezentiĝantaj	pre-zen-t-iĝ-an-t-aj
prezentiĝas	pre-zen-t-iĝ-as
prezentiĝus	pre-zen-t-iĝ-us
prezentis	pre-zen-t-is
prezentu	pre-zen-tu
prezentus	pre-zen-t-us
prezidanto	pre-zi-d-an-to
prezidi	pre-zi-di
prezido	pre-zi-do
prezo	pre-zo
pridemandis	pri-de-man-d-is
pridemandos	pri-de-man-d-os
pridiskuton	pri-di-s-ku-t-on
prijuĝado	pri-ju-ĝ-ado
prijuĝi	pri-ju-ĝi
prilaborata	pri-la-bo-r-ata
prilabori	pri-la-bo-ri
prilaboris	pri-la-bo-r-is
prilaboron	pri-la-bo-r-on
primaro	pri-ma-ro
primato	pri-ma-to
primitiva	pri-mi-ti-va
primitivaj	pri-mi-ti-v-aj
primitivan	pri-mi-ti-v-an
princino	prin-ci-no
principa	prin-ci-pa
principe	prin-ci-pe
principo	prin-ci-po
principoj	prin-ci-p-oj
principon	prin-ci-p-on
princo	prin-co
printempo	prin-tem-po
prioritato	pri-o-ri-ta-to
priparoli	pri-pa-roli
priparolitaj	pri-pa-rol-i-t-aj
pripensas	pri-pen-sas
pripensema	pri-pen-sema
pripensi	pri-pen-si
pripensita	pri-pen-sita
pripenso	pri-pen-so
pripensos	pri-pen-sos
pripensu	pri-pen-su
priserĉo	pri-ser-ĉo
priskriba	pri-skri-ba
priskribo	pri-skri-bo
priskriboj	pri-skri-b-oj
priskribon	pri-skri-b-on
prismo	pris-mo
privata	pri-va-ta
privataj	pri-va-t-aj
privatan	pri-va-t-an
privilegia	pri-vi-le-gia
prizorgante	pri-zorg-an-te
prizorgas	pri-zorg-as
prizorgos	pri-zorg-os
probabla	pro-ba-b-la
problema	pro-b-lema
problemetoj	pro-b-lem-et-oj
problemo	pro-b-lemo
problemoj	pro-b-lem-oj
problemon	pro-b-lem-on
procedi	pro-ce-di
procedo	pro-ce-do
procedoj	pro-ce-d-oj
procentego	pro-cen-t-ego
procento	pro-cen-to
proceso	pro-ce-so
prodigo	pro-di-go
produkto	pro-duk-to
produktoj	pro-duk-t-oj
produkton	pro-duk-t-on
prof	prof
profano	pro-fa-no
profesia	pro-fe-sia
profesio	pro-fe-sio
profesion	pro-fe-si-on
profesorinon	pro-fe-so-ri-n-on
profesoro	pro-fe-so-ro
profesoron	pro-fe-so-r-on
profeto	pro-fe-to
profitcela	pro-fit-ce-la
profito	pro-fi-to
profunda	pro-fun-da
profundaĵon	pro-fun-d-aĵ-on
profundapensaj	pro-fun-da-pen-s-aj
profundiĝu	pro-fun-d-iĝu
programo	pro-gra-mo
progresas	pro-gre-s-as
progresi	pro-gre-si
projektistoj	pro-jek-t-ist-oj
projektita	pro-jek-t-ita
projekto	pro-jek-to
projektoj	pro-jek-t-oj
projekton	pro-jek-t-on
prokrasti	pro-kra-s-ti
proksima	prok-si-ma
proksimaj	prok-si-m-aj
proksime	prok-si-me
proksimeco	prok-si-m-eco
proksimiĝas	prok-si-m-iĝ-as
proksimiĝi	prok-si-m-iĝi
proksimiĝis	prok-si-m-iĝ-is
proksimuma	prok-si-m-uma
proksimuman	prok-si-m-um-an
proksimume	prok-si-m-ume
proletario	pro-le-ta-rio
proleto	pro-le-to
promenas	pro-me-n-as
promeni	pro-me-ni
promenis	pro-me-n-is
promesas	pro-me-s-as
promesi	pro-me-si
promesis	pro-me-s-is
promeson	pro-me-s-on
pronomo	pro-no-mo
pronomoj	pro-no-m-oj
prononci	pro-non-ci
propagandi	pro-pa-gan-di
proponata	pro-po-n-ata
proponi	pro-po-ni
proponis	pro-po-n-is
proponita	pro-po-n-ita
proponite	pro-po-n-ite
propono	pro-po-no
proponoj	pro-po-n-oj
proponon	pro-po-n-on
proponos	pro-po-n-os
propozicio	pro-po-zi-cio
propra	pro-pra
propraj	pro-pr-aj
propran	pro-pr-an
propre	pro-pre
prosperi	pro-s-pe-ri
prosperis	pro-s-pe-r-is
prosperos	pro-s-pe-r-os
protekti	pro-tek-ti
protestanto	pro-tes-t-an-to
protestantoj	pro-tes-t-an-t-oj
protestas	pro-tes-t-as
protesti	pro-tes-ti
protestis	pro-tes-t-is
protestus	pro-tes-t-us
provante	pro-v-an-te
provas	pro-v-as
proverbo	pro-ver-bo
provi	pro-vi
provincano	pro-vin-ca-no
provincestro	pro-vin-c-es-tro
provinco	pro-vin-co
provis	pro-v-is
provizo	pro-vi-zo
provizoj	pro-vi-z-oj
provĵeto	prov-ĵe-to
provnumero	prov-nu-me-ro
provo	pro-vo
provoj	pro-v-oj
provoki	pro-vo-ki
provon	pro-v-on
provos	pro-v-os
provpafo	prov-pa-fo
provrezultojn	prov-re-zul-t-ojn
provu	pro-vu
provversio	prov-ver-sio
prozelito	pro-ze-li-to
prozo	pro-zo
prudenta	pru-den-ta
prudentaj	pru-den-t-aj
prudente	pru-den-te
prudento	pru-den-to
pruno	pru-no
prunte	prun-te
pruntedoni	prun-te-do-ni
pruntepreni	prun-te-pre-ni
prunti	prun-ti
prunto	prun-to
pruvas	pru-v-as
pruvi	pru-vi
pruvis	pru-v-is
pruvita	pru-v-ita
pruvos	pru-v-os
pseŭdoinstruitaj	pseŭ-do-ins-tru-it-aj
pseŭdoscienco	pseŭ-do-sci-en-co
pseŭdoturka	pseŭ-do-tur-ka
psiĥologio	psi-ĥo-lo-gio
psikologio	psi-ko-lo-gio
psilo	psi-lo
pterodaktilo	pte-ro-dak-ti-lo
publika	pu-b-li-ka
publikaj	pu-b-li-k-aj
publikigis	pu-b-li-k-ig-is
publiko	pu-b-li-ko
publikon	pu-b-li-k-on
pudingo	pu-din-go
pudro	pu-dro
pufvangaj	puf-van-g-aj
pugno	pug-no
pulardo	pu-lar-do
pulmo	pul-mo
pulo	pu-lo
pulvo	pul-vo
pulvora	pul-vo-ra
pulvoro	pul-vo-ro
pumo	pu-mo
pumpi	pum-pi
punclipa	punc-li-pa
puni	pu-ni
punkcio	punk-cio
punkto	punk-to
punktoj	punk-t-oj
punktokomo	punk-to-ko-mo
punto	pun-to
pupilo	pu-pi-lo
pupo	pu-po
pura	pu-ra
pure	pu-re
purema	pu-r-ema
purigi	pu-r-igi
puso	pu-so
pustulo	pu-s-tu-lo
puŝĉaron	puŝ-ĉar-on
puŝi	puŝi
puŝiĝas	puŝ-iĝ-as
puŝveturilo	puŝ-ve-tu-r-ilo
puto	pu-to
putri	pu-tri
rabato	ra-ba-to
rabeno	ra-be-no
rabi	ra-bi
raboto	ra-bo-to
racio	ra-cio
radaro	ra-da-ro
radiatoro	ra-di-ato-ro
radikaj	ra-di-k-aj
radikale	ra-di-ka-le
radikaloj	ra-di-ka-l-oj
radikaro	ra-di-k-aro
radikaron	ra-di-k-ar-on
radiko	ra-di-ko
radikoj	ra-di-k-oj
radikon	ra-di-k-on
radio	ra-dio
rado	rado
radŝpinilo	rad-ŝpi-n-ilo
rafano	ra-fa-no
rajdĉevalon	rajd-ĉe-va-l-on
rajdi	raj-di
rajtas	raj-t-as
rajtigi	raj-t-igi
rajto	raj-to
rajton	raj-t-on
raketo	ra-ke-to
rakontas	ra-kon-t-as
rakonti	ra-kon-ti
rakontis	ra-kon-t-is
rakonto	ra-kon-to
rakontoj	ra-kon-t-oj
rakonton	ra-kon-t-on
rakontos	ra-kon-t-os
rakontu	ra-kon-tu
ralf	ralf
rampaĵo	ram-p-aĵo
rampi	ram-pi
rando	ran-do
rango	ran-go
rangon	ran-g-on
rano	ra-no
rapida	ra-pi-da
rapidas	ra-pi-d-as
rapide	ra-pi-de
rapideco	ra-pi-d-eco
rapidiĝas	ra-pi-d-iĝ-as
rapidis	ra-pi-d-is
rapidos	ra-pi-d-os
rapidu	ra-pi-du
raportas	ra-por-t-as
raporti	ra-por-ti
raportis	ra-por-t-is
raporto	ra-por-to
raporton	ra-por-t-on
raportos	ra-por-t-os
raportu	ra-por-tu
rasoj	ra-s-oj
rato	rato
raŭka	raŭ-ka
raŭpo	raŭ-po
ravi	ra-vi
razi	ra-zi
reagis	re-ag-is
reago	re-ago
reakcio	re-ak-cio
reala	re-ala
realigado	re-alig-ado
realigis	re-alig-is
realiĝo	re-al-iĝo
rebati	re-ba-ti
rebato	re-b-ato
rebonigi	re-bo-n-igi
rebrili	re-bri-li
recenzi	re-cen-zi
recepto	re-cep-to
reciproka	re-ci-pro-ka
reciprokaj	re-ci-pro-k-aj
reciprokan	re-ci-pro-k-an
reciproke	re-ci-pro-ke
redakti	re-dak-ti
redaktitaj	re-dak-t-it-aj
redaktoro	re-dak-to-ro
redingoto	re-din-go-to
rediras	re-dir-as
rediri	re-diri
redoni	re-do-ni
redukti	re-duk-ti
referencnumero	re-fe-renc-nu-me-ro
referendumo	re-fe-ren-du-mo
refermas	re-ferm-as
reflekti	re-flek-ti
refligilo	ref-lig-ilo
reformi	re-for-mi
regado	re-g-ado
regali	re-ga-li
regato	re-g-ato
regi	re-gi
regimentestro	re-gi-men-t-es-tro
regimento	re-gi-men-to
regiono	re-gi-o-no
registaroj	re-g-ist-ar-oj
registraĵoj	re-gi-s-tr-aĵ-oj
registritaj	re-gi-s-tr-it-aj
registro	re-gi-s-tro
reglamento	re-gla-men-to
regna	reg-na
regnaj	reg-n-aj
regnano	reg-na-no
regnestro	reg-n-es-tro
regno	reg-no
regnoj	reg-n-oj
regula	re-gula
regulaj	re-gul-aj
regule	re-gule
reguleco	re-gul-eco
regulecon	re-gul-ec-on
regulelementoj	re-gul-ele-ment-oj
reguletoj	re-gul-et-oj
regulo	re-gulo
reguloj	re-gul-oj
regulon	re-gul-on
reĝidan	reĝ-id-an
reĝidina	reĝ-id-ina
reĝidinaj	reĝ-id-in-aj
reĝidinajn	reĝ-id-in-ajn
reĝidinan	reĝ-id-in-an
reĝidine	reĝ-id-ine
reĝidino	reĝ-id-ino
reĝidinoj	reĝ-id-in-oj
reĝidinojn	reĝ-id-in-ojn
reĝidinon	reĝ-id-in-on
reĝido	reĝ-ido
reĝidoj	reĝ-id-oj
reĝidojn	reĝ-id-ojn
reĝimo	re-ĝi-mo
reĝisoron	reĝi-so-r-on
reĝlando	reĝ-lan-do
reĝo	reĝo
reĝoj	reĝ-oj
reĝolando	reĝo-lan-do
reĝustigi	re-ĝu-s-t-igi
rehabilito	re-ha-bi-li-to
reiri	re-iri
reiris	re-ir-is
reĵetis	re-ĵe-t-is
rekaŝu	re-ka-ŝu
reklami	re-kla-mi
reklamo	re-kla-mo
reklamon	re-kla-m-on
rekomencos	re-ko-men-c-os
rekomendi	re-ko-men-di
rekomendite	re-ko-men-d-ite
rekomendoj	re-ko-men-d-oj
rekompenco	re-kom-pen-co
rekonas	re-ko-n-as
rekonis	re-ko-n-is
rekonos	re-ko-n-os
rekordo	re-kor-do
rekta	rek-ta
rektaj	rek-t-aj
rektangulo?	rek-tan-gu-lo
rekte	rek-te
rekunigi	re-ku-n-igi
rekunigitaj	re-ku-n-ig-it-aj
rekunmeti	re-kun-meti
rekuŝiĝis	re-ku-ŝ-iĝ-is
rekvizito	re-k-vi-zi-to
relativa	re-la-ti-va
relativeco	re-la-ti-v-eco
relegi	re-le-gi
relegu	re-le-gu
religia	re-li-gia
religio	re-li-gio
religioj	re-li-gi-oj
religiscienco	re-li-gi-sci-en-co
relo	re-lo
remalsaniĝo	re-mal-sa-n-iĝo
rememorigados	re-me-mo-r-ig-ad-os
rememoris	re-me-mo-r-is
rememoru	re-me-mo-ru
remeto	re-me-to
remi	remi
remonto	re-mon-to
remparo	rem-pa-ro
remŝipo	rem-ŝipo
renato	re-na-to
rendevuo	ren-de-vuo
renkontadis	ren-kon-t-ad-is
renkontas	ren-kon-t-as
renkonti	ren-kon-ti
renkontiĝis	ren-kon-t-iĝ-is
renkontis	ren-kon-t-is
renkontita	ren-kon-t-ita
renkonto	ren-kon-to
renkontos	ren-kon-t-os
renkontus	ren-kon-t-us
reno	re-no
rento	ren-to
renversi	ren-ver-si
renversiĝi	ren-ver-siĝi
replenigu	re-ple-n-igu
reprezentantoj	re-pre-zen-t-an-t-oj
reprezenti	re-pre-zen-ti
reprezentita	re-pre-zen-t-ita
reprezentitaj	re-pre-zen-t-it-aj
resp	resp
respegulas	re-s-pe-gu-l-as
respekti	re-s-pek-ti
respektiva	re-s-pek-ti-va
respekton	re-s-pek-t-on
respondas	res-pon-d-as
respondeco	res-pon-d-eco
respondi	res-pon-di
respondis	res-pon-d-is
responditaj	res-pon-d-it-aj
respondo	res-pon-do
respondon	res-pon-d-on
respondos	res-pon-d-os
respondu	res-pon-du
respubliko	res-pu-b-li-ko
restaj	res-t-aj
restas	res-t-as
resti	res-ti
restis	res-t-is
resto	res-to
restoracio	res-to-ra-cio
restoracion	res-to-ra-ci-on
restos	res-t-os
restu	res-tu
restus	res-t-us
resuman	re-su-m-an
resumante	re-su-m-an-te
resume	re-su-me
resumo	re-su-mo
reŝlosis	re-ŝlo-s-is
retajn	ret-ajn
rete	rete
reteni	re-te-ni
retikulo	re-ti-ku-lo
reto	reto
retorto	re-tor-to
retrankviliĝi	re-trank-vi-l-iĝi
retrovi	retro-vi
retroviĝas	retro-v-iĝ-as
retroviĝis	retro-v-iĝ-is
retrovis	retro-v-is
retrovos	retro-v-os
returne	re-turne
revenas	re-ve-n-as
reveni	re-ve-ni
revenis	re-ve-n-is
revenos	re-ve-n-os
revenu	re-ve-nu
revi	re-vi
revidi	re-vi-di
revidis	re-vi-d-is
revido	re-v-ido
revigligo	re-vi-gligo
revizii	re-vi-zii
revolucii	re-vo-lu-cii
revolucion	re-vo-lu-ci-on
revuo	re-vuo
revuoj	re-vu-oj
rezervo	re-zer-vo
rezido	re-zi-do
rezigni	re-zig-ni
rezisti	re-zi-s-ti
rezisto	re-zi-s-to
rezoni	re-zo-ni
rezulta	re-zul-ta
rezultantan	re-zul-t-an-t-an
rezultas	re-zul-t-as
rezultato	re-zul-ta-to
rezulti	re-zul-ti
rezulto	re-zul-to
rezultoj	re-zul-t-oj
ribeli	ri-be-li
ribo	ri-bo
ricevas	ri-ce-v-as
ricevataj	ri-ce-v-at-aj
ricevi	ri-ce-vi
ricevinte	ri-ce-v-in-te
ricevis	ri-ce-v-is
ricevita	ri-ce-v-ita
ricevitaj	ri-ce-v-it-aj
ricevos	ri-ce-v-os
ricevus	ri-ce-v-us
riĉa	ri-ĉa
riĉaj	ri-ĉ-aj
riĉan	ri-ĉ-an
riĉeco	ri-ĉ-eco
riĉecon	ri-ĉ-ec-on
riĉiĝado	ri-ĉ-iĝ-ado
riĉiĝadus	ri-ĉ-iĝ-ad-us
riĉulo	ri-ĉ-ulo
ridaĉo	ri-d-aĉo
ridado	ri-d-ado
ridante	ri-d-an-te
ridas	ri-d-as
ridegas	ri-d-eg-as
ridego	ri-d-ego
ridegos	ri-d-eg-os
rideti	ri-d-eti
rideto	ri-d-eto
ridi	ri-di
ridinda	ri-d-inda
ridindaj	ri-d-ind-aj
ridinde	ri-d-inde
ridindigis	ri-d-ind-ig-is
ridon	rid-on
ridu	ri-du
rifuĝi	ri-fu-ĝi
rifuzi	ri-fuzi
rifuziĝi	ri-fuz-iĝi
rifuzis	ri-fuz-is
rifuzo	ri-fuzo
rifuzos	ri-fuz-os
rifuzus	ri-fuz-us
rigardadi	ri-gar-d-adi
rigardante	ri-gar-d-an-te
rigardas	ri-gar-d-as
rigardataj	ri-gar-d-at-aj
rigardi	ri-gar-di
rigardis	ri-gar-d-is
rigardo	ri-gar-do
rigardos	ri-gar-d-os
rigardu	ri-gar-du
rigida	ri-gi-da
riglilo	ri-gl-ilo
rikolti	ri-kol-ti
rikoltilo	ri-kol-t-ilo
rilata	ri-la-ta
rilatas	ri-la-t-as
rilate	ri-la-te
rilati	ri-la-ti
rilatis	ri-la-t-is
rilato	ri-la-to
rilatoj	ri-la-t-oj
rilatos	ri-la-t-os
rilatus	ri-la-t-us
rimarkante	ri-mar-kan-te
rimarkas	ri-mar-k-as
rimarkebla	ri-mar-k-eb-la
rimarki	ri-mar-ki
rimarkigo	ri-mar-k-igo
rimarkigoj	ri-mar-k-ig-oj
rimarkinda	ri-mar-k-inda
rimarkinde	ri-mar-k-inde
rimarkis	ri-mar-k-is
rimarko	ri-mar-ko
rimarkoj	ri-mar-k-oj
rimarkon	ri-mar-k-on
rimedo	ri-me-do
rimedoj	ri-me-d-oj
rimedon	ri-me-d-on
rimeno	ri-me-no
rimo	ri-mo
ringego	rin-g-ego
ringo	rin-go
ripari	ri-pa-ri
ripariston	ri-pa-r-ist-on
riparo	ri-pa-ro
ripetadas	ri-pe-t-ad-as
ripetadi	ri-pe-t-adi
ripetadis	ri-pe-t-ad-is
ripetas	ri-pet-as
ripeti	ri-peti
ripetiĝis	ri-pe-t-iĝ-is
ripeto	ri-peto
ripo	ri-po
ripozi	ri-po-zi
ripozlokoj	ri-poz-lo-k-oj
riproĉi	ri-pro-ĉi
riproĉmotivojn	ri-proĉ-mo-ti-v-ojn
riskas	ri-s-k-as
riskema	ri-s-k-ema
riski	ri-s-ki
risko	ri-s-ko
riskoj	ri-s-k-oj
riskos	ri-s-k-os
rismo	ris-mo
ritmo	rit-mo
riveli	ri-ve-li
riverenci	ri-ve-ren-ci
rivereto	ri-ve-reto
rivero	ri-ve-ro
rivoluo	ri-vo-luo
rizherbo	riz-her-bo
rizo	ri-zo
robo	ro-bo
roboto	ro-bo-to
rodrigo	ro-dri-go
rokoj	ro-k-oj
rolo	ro-lo
rolon	ro-l-on
romana	ro-ma-na
romano	ro-ma-no
rombfiŝo	romb-fi-ŝo
rompas	rom-p-as
rompebla	rom-p-eb-la
rompi	rom-pi
rompis	rom-p-is
rompŝtelisto	romp-ŝte-l-isto
ronda	ron-da
rondo	ron-do
ronga	ron-ga
ronki	ron-ki
roso	ro-so
rosti	ro-s-ti
roto	ro-to
rozalinda	ro-za-lin-da
rozfingra	roz-fin-gra
rozĝardenon	roz-ĝar-de-n-on
rozkolora	roz-ko-lo-ra
roznuancis	roz-nu-an-c-is
rozo	ro-zo
rozsimile	roz-si-mi-le
rubaĵsako	ru-baĵ-sa-ko
rubando	ru-ban-do
rubrikoj	ru-bri-k-oj
rubuso	ru-bu-so
rufhara	ruf-hara
ruĝa	ru-ĝa
ruĝaj	ru-ĝ-aj
ruĝgorĝulo	ruĝ-gor-ĝ-ulo
ruĝhaŭtuloj	ruĝ-haŭ-t-ul-oj
ruĝiĝi	ru-ĝ-iĝi
ruĝiĝos	ru-ĝ-iĝ-os
ruĝiĝus	ru-ĝ-iĝ-us
ruĝvanga	ruĝ-van-ga
ruinigi	ru-i-n-igi
ruino	ru-i-no
rukulo	ru-ku-lo
ruli	ru-li
rulknedilo	rul-kne-d-ilo
rulkurteno	rul-kur-te-no
rulo	ru-lo
rumanino	ru-ma-ni-no
rumano	ru-ma-no
rusa	ru-sa
ruslanda	rus-lan-da
ruslingva	rus-lin-g-va
ruso	ru-so
russlango	rus-slan-go
rusto	ru-s-to
rusujano	ru-su-ja-no
rusujo	ru-s-ujo
rutinaj	ru-ti-n-aj
rutinistoj	ru-ti-n-ist-oj
rutino	ru-ti-no
rutinuloj	ru-ti-n-ul-oj
ruza	ruza
ruzaĵon	ruz-aĵ-on
rvas	rv-as
sabato	sa-ba-to
sablaĵo	sa-b-l-aĵo
sablero	sa-b-le-ro
sablo	sa-b-lo
sablujo	sa-bl-ujo
saboto	sa-bo-to
sacerdoto	sa-cer-do-to
safrano	sa-fra-no
sagaca	sa-ga-ca
sago	sa-go
sagformaj	sag-for-m-aj
saĝa	sa-ĝa
saĝaj	sa-ĝ-aj
saĝe	sa-ĝe
saĝo	sa-ĝo
saĝulo	sa-ĝ-ulo
saĝuloj	sa-ĝ-ul-oj
sako	sa-ko
sakon	sa-k-on
sakstraton	sak-strat-on
salajro	sa-laj-ro
salamoniako	sa-la-mo-ni-ako
salato	sa-la-to
saliko	sa-li-ko
salo	sa-lo
salono	sa-lo-no
salpingo	sal-pin-go
saltas	sal-t-as
salti	sal-ti
saltoŝnuro	sal-to-ŝnu-ro
saluti	sa-lu-ti
salutis	sa-lu-t-is
saluton	sa-lu-t-on
sama	sama
samaj	sam-aj
saman	sam-an
samara	sa-ma-ra
samarkanda	sa-mar-kan-da
same	same
samgentanoj	sam-gen-ta-n-oj
samklasanoj	sam-kla-sa-n-oj
samlernejanoj	sam-ler-ne-ja-n-oj
samon	sam-on
samovaro	samo-va-ro
samregnano	sam-reg-na-no
samreligiano	sam-re-li-gi-ano
samslipa	sam-sli-pa
samtempe	sam-tem-pe
samtempuloj	sam-tem-p-ul-oj
samumo	sa-mu-mo
samurajo	sa-mu-ra-jo
samurbano	sam-urba-no
sana	sa-na
sandviĉo	sand-vi-ĉo
sanejo	sa-n-ejo
sango	san-go
saniga	sa-n-iga
sanigejo	sa-ni-g-ejo
sanigi	sa-n-igi
sanigilo	sa-n-ig-ilo
saniĝi	sa-n-iĝi
sanitaro	sa-ni-ta-ro
sankcion	sank-ci-on
sankta	sank-ta
sanktaj	sank-t-aj
sankte	sank-te
sanktejo	sank-t-ejo
sanktoleito?	sank-t-ole-ito
sanktoleo?	sank-t-oleo
sanosubtenanta	sa-no-sub-te-n-an-ta
sanskrita	san-skri-ta
sanstato	san-sta-to
sanulo	sa-n-ulo
sapo	sa-po
sapŝaŭmo	sap-ŝaŭ-mo
sarki	sar-ki
sata	sata
satdormis	sat-dorm-is
satelito	sa-te-li-to
satiro	sa-tiro
saŭco	saŭ-co
savano	sa-va-no
savi	sa-vi
savis	sa-v-is
savita	sa-v-ita
savjako	sav-ja-ko
savonto	sa-v-onto
savŝnuro	sav-ŝnu-ro
savzono	sav-zo-no
sceno	sce-no
sceptron	scep-tr-on
scia	scia
sciado	sci-ado
scianta	sci-an-ta
sciante	sci-an-te
scianto	sci-an-to
scias	sci-as
sciata	sci-ata
sciate	sci-ate
scienca	sci-en-ca
sciencaj	sci-en-c-aj
sciencakademia	sci-en-ca-ka-de-mia
sciencakademio	sci-en-ca-ka-de-mio
sciencan	sci-en-c-an
sciencesplora	sci-en-ce-s-plo-ra
sciencfikcia	sci-encfik-cia
scienckomprenantajn	sci-enc-kom-pre-n-an-t-ajn
scienco	sci-en-co
sciencoj	sci-en-c-oj
sciencoplena	sci-en-co-ple-na
sciencprinco	sci-enc-prin-co
scienculoj	sci-en-c-ul-oj
sciero	sci-e-ro
scieti	sci-eti
scii	scii
sciigi	sci-igi
sciiĝi	sci-iĝi
sciis	sci-is
scintila	scin-ti-la
scio	scio
scioj	sci-oj
scion	sci-on
scios	sci-os
scipovi	sci-po-vi
sciu	sciu
sciura	sci-ura
sciuro	sci-uro
scius	sci-us
scivola	sci-vo-la
scivolaj	sci-vo-l-aj
scivolema	sci-vo-l-ema
scivolis	sci-vo-l-is
scivolo	sci-vo-lo
segi	segi
segilo	se-g-ilo
seĝeto	se-ĝ-eto
seĝo	se-ĝo
seĝon	se-ĝ-on
seka	se-ka
sekaĵo	se-k-aĵo
sekalo	se-ka-lo
sekci	sek-ci
sekcio	sek-cio
sekcion	sek-ci-on
seke	se-ke
sekigis	se-k-ig-is
sekigrako?	se-ki-gra-ko
sekigŝnuro	se-kig-ŝnu-ro
sekigŝranko	se-kig-ŝran-ko
sekreta	se-kre-ta
sekretaj	se-kre-t-aj
sekretan	se-kre-t-an
sekretario	se-kre-ta-rio
sekrete	se-kre-te
sekrethava	se-kret-ha-va
sekreto	se-kre-to
sekreton	se-kre-t-on
seksekscita	seks-eks-ci-ta
seksismo	sek-s-ismo
sekslogo	seks-lo-go
sekso	sek-so
sekson	sek-s-on
seksumaj	sek-s-um-aj
seksumajn	sek-s-um-ajn
seksumeca	sek-s-um-eca
seksumis	sek-s-um-is
seksumoj	sek-s-um-oj
seksumojn	sek-s-um-ojn
seksumon	sek-s-um-on
seksumos	sek-s-um-os
seksumu	sek-s-umu
seksumus	sek-s-um-us
sekulara	se-ku-la-ra
sekundara	se-kun-da-ra
sekundo	se-kun-do
sekura	se-ku-ra
sekvado	se-k-v-a-do
sekvan	se-k-v-an
sekvanta	se-kvan-ta
sekvantaj	se-kvan-t-aj
sekvantan	se-kvan-t-an
sekvante	se-kvan-te
sekvas	se-k-v-as
sekvasemajne	se-k-va-se-majne
sekve	se-k-ve
sekvi	se-k-vi
sekvinbero	sek-vin-be-ro
sekvis	se-k-v-is
sekvoj	se-k-v-oj
sekvos	se-k-v-os
sekvu	se-k-vu
sekvus	se-k-v-us
sema	sema
semajno	se-maj-no
semajnoj	se-maj-n-oj
semajnon	se-maj-n-on
semis	sem-is
semo	semo
semoj	sem-oj
senaan	sena-an
senadresa	sen-ad-resa
senantaŭjuĝa	sen-an-taŭ-ju-ĝa
senantaŭjuĝaj	sen-an-taŭ-ju-ĝ-aj
senaon	sena-on
senato	sena-to
senbezona	sen-be-zo-na
sencdiferenco	senc-di-fe-ren-co
sencela	sen-ce-la
sencelaj	sen-ce-l-aj
senceremonia	sen-ce-re-mo-nia
senchavan	senc-ha-v-an
sencnuanco	senc-nu-an-co
senco	sen-co
sencon	sen-c-on
senconuancoj	sen-co-nu-an-c-oj
senĉesan	sen-ĉe-s-an
senĉese	sen-ĉe-se
sendanka	sen-dan-ka
sendi	sen-di
sendiferenca	sen-di-fe-ren-ca
sendifina	sen-di-fi-na
sendos	sen-d-os
senduba	sen-du-ba
sendubaj	sen-du-b-aj
senduban	sen-du-b-an
sendube	sen-du-be
sendubeco	sen-du-b-eco
Seneko	se-ne-ko
senenhava	sen-en-ha-va
senerare	sen-e-ra-re
senesenca	sen-esen-ca
seneskalo	senes-ka-lo
senespera	sen-es-pe-ra
senfinan	sen-fi-n-an
senfine	sen-fine
senfineco	sen-fi-n-eco
senforta	sen-for-ta
senfortaj	sen-for-t-aj
senfrukta	sen-fruk-ta
senfundamenta	sen-fun-da-men-ta
senfundamentecon	sen-fun-da-men-t-ec-on
senhelpa	sen-hel-pa
senhelpaj	sen-hel-p-aj
senhelpe	sen-hel-pe
senhelpecon	sen-hel-pe-c-on
senhezite	sen-he-zi-te
senigis	sen-ig-is
senila	senila
seninflua	sen-in-flua
seninflueco	sen-in-flu-eco
senintence	sen-in-ten-ce
senkleraj	sen-kle-r-aj
senkompare	sen-kom-pa-re
senkompate	sen-kom-pa-te
senkonscia	sen-kon-scia
senkonscie	sen-kon-scie
senkonsciigi	sen-kon-sci-igi
senkonsciigita	sen-kon-sci-ig-ita
senkuraĝaj	sen-ku-ra-ĝ-aj
senkuraĝiga	sen-ku-ra-ĝ-iga
senligaj	sen-lig-aj
senlima	sen-li-ma
senmanke	sen-man-ke
senmerita	sen-me-ri-ta
senmorta	sen-mor-ta
senmove	sen-mo-ve
sennaciismo	sen-na-ci-ismo
sennaciulo	sen-na-ci-ulo
senorda	sen-or-da
senordan	sen-or-d-an
senpage	sen-pa-ge
senpezigos	sen-pe-z-ig-os
senpruve	sen-pru-ve
senrevene	sen-re-vene
sensaĝaj	sen-sa-ĝ-aj
senscia	sen-scia
sensencaj	sen-sen-c-aj
sensencaĵo	sen-sen-c-aĵo
sensencaĵoj	sen-sen-c-aĵ-oj
sensencaĵon	sen-sen-c-aĵ-on
sensencan	sen-sen-c-an
sensence	sen-sen-ce
sensignifaj	sen-sig-ni-f-aj
sensignifan	sen-sig-ni-f-an
senskrupula	sen-skru-pu-la
sensleda	sen-sle-da
senso	sen-so
sensoifigan	sen-so-if-ig-an
sensperta	sen-sper-ta
senstreĉa	sen-stre-ĉa
senŝanĝe	sen-ŝan-ĝe
senŝeligi	sen-ŝe-ligi
sentas	sen-t-as
sentebla?	sen-t-eb-la
sentema	sente-ma
sentemeco	sente-m-eco
sentemo	sent-e-mo
senti	sen-ti
sentimulino	sen-ti-m-ul-ino
sentis	sen-t-is
sento	sen-to
sentoj	sen-t-oj
sentu	sen-tu
sentus	sen-t-us
senutila	sen-uti-la
senvorta	sen-vorta
senvorte	sen-vorte
sepbita	sep-bi-ta
sepcent	sep-cent
sepdek	sep-dek
seponoj	sep-on-oj
sepope	sep-ope
septembro	sep-tem-bro
serĉantaj	ser-ĉ-an-t-aj
serĉe	ser-ĉe
serĉi	ser-ĉi
serĉilo	ser-ĉ-ilo
serĉis	ser-ĉ-is
serena	se-re-na
serenadoj	se-re-na-d-oj
serio	se-rio
serioj	se-ri-oj
serion	se-ri-on
serioza	se-ri-o-za
seriozaj	se-ri-o-z-aj
serioze	se-ri-o-ze
seriozmiene	se-ri-oz-mi-ene
serpento	ser-pen-to
serumo	se-ru-mo
seruro	se-ru-ro
seruroj	se-ru-r-oj
seruron	se-ru-r-on
servantan	ser-v-an-t-an
servanto	ser-v-an-to
servas	ser-v-as
servema	ser-v-ema
servi	ser-vi
servistino	ser-v-ist-ino
servo	ser-vo
servon	ser-v-on
servsoldaton	serv-sol-da-t-on
sesdek	ses-dek
seshora	ses-ho-ra
sesjara	ses-jara
sesonojn	ses-on-ojn
sesope	ses-ope
severa	se-ve-ra
severaj	se-ve-r-aj
severe	se-ve-re
sezono	se-zo-no
sferoj	sfe-r-oj
siaflanke	sia-flan-ke
siaj	siaj
sian	sian
siatempa	sia-tem-pa
sibaritoj	si-ba-ri-t-oj
sida	sida
Sidarto	si-dar-to
sidas	si-d-as
sidi	si-di
sidigi	si-d-igi
sidiĝas	si-d-iĝ-as
sidiĝi	si-d-iĝi
sidiĝis	si-d-iĝ-is
sidis	si-d-is
sidlokon	sid-lo-k-on
sidon	sid-on
sidu	si-du
sigelvakso	si-gel-vak-so
signalo	sig-na-lo
signalon	sig-na-l-on
signalŝnuro	sig-nal-ŝnu-ro
signetoj	sig-n-et-oj
signifanta	sig-ni-f-an-ta
signifas	sig-ni-f-as
signifi	sig-ni-fi
signifo	sig-ni-fo
signifoj	sig-ni-f-oj
signifokategorio	sig-ni-fo-ka-te-go-rio
signifon	sig-ni-f-on
signifus	sig-ni-f-us
signo	sig-no
signoj	sig-n-oj
silablimo?	si-la-b-li-mo
silabvosto	si-lab-vo-s-to
silenta	si-len-ta
silentadis	si-len-t-ad-is
silentadon	si-len-t-ad-on
silentas	si-len-t-as
silente	si-len-te
silentema	si-len-te-ma
silenteman	si-len-te-m-an
silenti	si-len-ti
silentigi	si-len-t-igi
silentis	si-len-t-is
silento	si-len-to
silenton	si-len-t-on
silentos	si-len-t-os
silko	sil-ko
simila	si-mi-la
similaj	si-mi-l-aj
similaĵoj	si-mi-l-aĵ-oj
similan	si-mi-l-an
simile	si-mi-le
simio	si-mio
simpatio	sim-pa-tio
simpatioj	sim-pa-ti-oj
simpla	sim-pla
simplan	sim-pl-an
simple	sim-ple
simptomo	simp-to-mo
simula	si-mu-la
sina	sina
sinagoga	sina-go-ga
sinakuza	sin-aku-za
sinamo	sina-mo
sinapa	sina-pa
sincera	sin-ce-ra
sincere	sin-ce-re
sincervoĉa	sin-cer-vo-ĉa
sindefendo	sin-de-fen-do
sindeteno	sin-de-te-no
sindevigo	sin-de-v-igo
sindikata	sin-di-ka-ta
sindikato	sin-di-ka-to
sindona	sin-do-na
sindonema	sin-do-n-ema
sinekdoĥo	sinek-do-ĥo
sinekuro	sine-ku-ro
sinerezo	sine-re-zo
sinergio	siner-gio
sinforgeso	sin-for-ge-so
singapura	sin-ga-pu-ra
singapuro	sin-ga-pu-ro
singarda	sin-gar-da
singulara	sin-gu-lara
singularo	sin-gu-laro
singulti	sin-gul-ti
sinĝena	sin-ĝe-na
sinistra	sini-s-tra
sinjordomo	sin-jor-do-mo
sinjorido	sin-jor-ido
sinjorino	sin-jor-i-no
sinjorinon	sin-jor-i-n-on
sinjoro	sin-joro
sinjoroj	sin-jor-oj
sinjorpreĝa	sin-jor-pre-ĝa
sinjorpreĝo	sin-jor-pre-ĝo
sinki	sin-ki
sinklino	sin-kli-no
sinkona	sin-ko-na
sinkopa	sin-ko-pa
sinkretismo	sin-kre-t-ismo
sinkrona	sin-kro-na
sinkronigi	sin-kro-n-igi
sino	sino
sinodo	sino-do
sinofero	sin-ofe-ro
sinokupado	sin-oku-p-ado
sinonimi	sino-ni-mi
sinonimika	sino-ni-mi-ka
sinonimo	sino-ni-mo
sinoptika	sinop-ti-ka
sinpelado	sin-pe-l-ado
sinprezento	sin-pre-zen-to
sinregada	sin-re-g-ada
sinsekva	sin-se-k-va
sinsekve	sin-se-k-ve
sinsekvon	sin-se-k-v-on
sintagmo	sin-tag-mo
sintaksa	sin-tak-sa
sinteno	sin-te-no
sintezi	sin-te-zi
sintruda	sin-tru-da
sinusarko	si-nu-sar-ko
sinuso	si-nu-so
sinvenenado	sin-ve-ne-n-ado
siringon	si-rin-g-on
sismo	sis-mo
sisteme	si-s-te-me
sistemeco	si-s-te-m-eco
sistemo	si-s-te-mo
sitelo	si-te-lo
situacio	si-tu-a-cio
situacion	si-tu-a-ci-on
situo	si-tuo
sizifan	si-zi-f-an
skalaro	ska-la-ro
skalo	ska-lo
skandinavaj	skan-di-na-v-aj
skarlata	skar-la-ta
skatoleto	ska-to-l-eto
skatolo	ska-to-lo
skeleto	ske-le-to
skemoj	ske-m-oj
sketa	sketa
skio	skio
skismoj	ski-s-m-oj
skisto	ski-s-to
skito	ski-to
sklavĉenojn	sklav-ĉe-n-ojn
sklavfoiro	sklav-fo-iro
sklavo	skla-vo
skleroto	skle-ro-to
skorpio	skor-pio
skoto	sko-to
skrapi	skrapi
skrapreto	skrap-reto
skrapvundo	skrap-vun-do
skriba	skri-ba
skribadis	skri-b-ad-is
skribado	skri-b-ado
skribas	skri-b-as
skribataj	skri-b-at-aj
skribe	skri-be
skribi	skri-bi
skribilajn	skri-b-il-ajn
skribilan	skri-b-il-an
skribilaro	skri-b-il-aro
skribilo	skri-b-ilo
skribilojn	skri-b-il-ojn
skribisto	skri-b-isto
skribita	skri-bi-ta
skribitaj	skri-bi-t-aj
skribitan	skri-bi-t-an
skribmanieron	skrib-ma-ni-e-r-on
skribon	skri-b-on
skribos	skri-b-os
skribotablo	skri-bo-ta-b-lo
skribovaro	skri-bo-va-ro
skribtablo	skrib-ta-b-lo
skroto	skro-to
skui	skui
skulpti	skul-p-ti
skulptilo	skul-p-t-ilo
skvamaranĝa	skvam-aran-ĝa
slabo	sla-bo
slalomisto	sla-lo-m-isto
slalomo	sla-lo-mo
slalomvetkuro	sla-lom-vet-ku-ro
slangaĵo	slan-g-aĵo
slango	slan-go
slavo	sla-vo
sledo	sle-do
slipo	sli-po
slofokso	slo-fok-so
slogano	slo-ga-no
slojdo	sloj-do
slovako	slo-va-ko
sloveno	slo-ve-no
slupo	slu-po
smalto	smal-to
smeraldo	sme-ral-do
smilako	smi-la-ko
smirgo	smir-go
smokingo	smo-kin-go
smuto	smu-to
Snitchey	snit-chey
snobino	sno-bi-no
snobismo	sno-b-ismo
snobo	sno-bo
snufo	snu-fo
sobra	so-bra
socia	so-cia
sociala	so-ci-ala
societo	so-ci-eto
societoj	so-ci-et-oj
socio	so-cio
sofinjo	so-fi-njo
sofismaĵo	so-fis-m-aĵo
sofismo	so-fis-mo
sofistoj	so-fis-t-oj
sofo	so-fo
soifa	so-ifa
soifas	so-if-as
soifi	so-ifi
soifon	so-if-on
sojlo	soj-lo
sola	so-la
solan	so-l-an
soldato	sol-da-to
soldatoj	sol-da-t-oj
sole	so-le
soleca	so-l-eca
solena	so-le-na
solene	so-lene
solidara	so-li-da-ra
solido	so-li-do
solvas	sol-v-as
solvi	sol-vi
solvis	sol-v-is
solvita	sol-v-ita
solvo	sol-vo
solvos	sol-v-os
somero	so-me-ro
somnambulo	som-nam-bu-lo
sonanta	so-n-an-ta
sonantaj	so-n-an-t-aj
sonaparato	so-n-apa-ra-to
sonas	so-n-as
sonato	so-na-to
soneto	so-ne-to
sonĝi	son-ĝi
soni	so-ni
sonimitoj?	so-ni-mi-t-oj
sonis	so-n-is
sonjo	so-njo
sono	so-no
sonoj	so-n-oj
sonoreco	so-no-r-eco
sonori	so-no-ri
sonorilo	so-no-r-ilo
sonoro	so-no-ro
sonserpento	son-ser-pen-to
sopiri	so-piri
soprano	so-pra-no
sorbi	sor-bi
sorcxbastono	sor-cxba-s-to-no
sorĉi	sor-ĉi
sorĉvortojn	sorĉ-vort-ojn
sorgo	sor-go
sorpo	sor-po
sorto	sor-to
sorton	sor-t-on
sovaĝa	so-va-ĝa
sovaĝaj	so-va-ĝ-aj
sovaĝe	so-va-ĝe
soveto	so-ve-to
spaco	spa-co
spagetoj	spa-ge-t-oj
spato	spato
speciala	spe-ci-ala
specialaj	spe-ci-al-aj
specialan	spe-ci-al-an
speciale	spe-ci-ale
specialisto	spe-ci-al-isto
specimeno	spe-ci-me-no
speco	spe-co
specoj	spe-c-oj
spegulo	spe-gu-lo
spektaklo	spek-ta-klo
spekula	spe-ku-la
sperta	sper-ta
spertaj	sper-t-aj
sperto	sper-to
spesmiloj	spes-mi-l-oj
spezi	spe-zi
spico	spi-co
spiko	spi-ko
spinaco	spi-na-co
spineto	spi-ne-to
spiona	spi-o-na
spione	spi-one
spioni	spi-o-ni
spionino	spi-o-ni-no
spiono	spi-o-no
spionoj	spi-o-n-oj
spionraporto	spi-on-ra-por-to
spirhalto	spir-hal-to
spiri	spiri
spirita	spi-ri-ta
spiritaj	spi-ri-t-aj
spiritĉeeston	spi-rit-ĉe-es-t-on
spirito	spi-ri-to
spiritoj	spi-ri-t-oj
spite	spi-te
spiti	spi-ti
splenda	splen-da
spleno	sple-no
splinto	splin-to
splito	spli-to
spongo	spon-go
sponta	sponta
sporto	spor-to
sportocentro	spor-to-cen-tro
sportoj	spor-t-oj
spoto	spo-to
sprinto	sprin-to
sprita	spri-ta
spritadi	spri-t-adi
spritaj	spri-t-aj
spritaĵoj	spri-t-aĵ-oj
spritaĵon	spri-t-aĵ-on
sprono	spro-no
spuro	spu-ro
stabila	sta-bi-la
stablo	sta-b-lo
stacidomo	sta-ci-do-mo
stacio	sta-cio
stadio	sta-dio
stadioj	sta-di-oj
stadiono	sta-di-o-no
stafeto	sta-fe-to
stalagmito	sta-lag-mi-to
stalaktito	sta-lak-ti-to
stalo	sta-lo
stameno	sta-me-no
stampo	stam-po
standardo	stan-dar-do
stango	stan-go
stano	sta-no
staradi	sta-r-adi
starantaj	sta-r-an-t-aj
staras	sta-r-as
stari	sta-ri
starigi	sta-r-igi
starigis	sta-r-ig-is
starigita	sta-r-ig-ita
starigitaj	sta-r-ig-it-aj
starigo	sta-r-igo
starigoprocedo	sta-ri-go-pro-ce-do
stariĝante	sta-r-iĝ-an-te
stariĝi	sta-r-iĝi
staris	sta-r-is
staros	sta-r-os
starti	star-ti
starus	sta-r-us
statistiko	sta-ti-s-ti-ko
stato	sta-to
statuo	sta-tuo
staturo	sta-tu-ro
stefano	ste-fa-no
stelo	ste-lo
stencilo	sten-ci-lo
sterko	ster-ko
sterlinga	ster-lin-ga
sterni	ster-ni
sternumo	ster-nu-mo
stigmato	stig-ma-to
stileto	sti-le-to
stilito	sti-li-to
stilo	sti-lo
stimula	sti-mu-la
stomako	sto-ma-ko
strando	stran-do
stranga	stran-ga
strangaj	stran-g-aj
strangan	stran-g-an
strange	stran-ge
stratadreso	strat-ad-reso
stratego	stra-te-go
strato	strato
stratoj	strat-oj
streĉi	stre-ĉi
streko	stre-ko
strida	stri-da
strigo	stri-go
striki	stri-ki
strikte	strik-te
stringo	strin-go
strio	strio
strobilo	stro-bi-lo
strofantino	stro-fan-tino
strofanto	stro-fan-to
strukturo	struk-tu-ro
strumo	strumo
struto	stru-to
studentinoj	stu-den-ti-n-oj
studento	stu-den-to
studentoj	stu-den-t-oj
studi	stu-di
studis	stu-d-is
studobjektoj	stu-dob-jek-t-oj
studoj	stu-d-oj
stulta	stul-ta
stulte	stul-te
stulteco	stul-t-eco
stumpo	stum-po
subaĉeti	sub-aĉe-ti
subaj	sub-aj
sube	sube
subgrupo	sub-gru-po
subiras	sub-ir-as
subiri	sub-iri
subita	su-bi-ta
subite	su-bi-te
subjektiva	sub-jek-ti-va
subjektiveco	sub-jek-ti-v-eco
subjekto	sub-jek-to
subkuŝi	sub-ku-ŝi
submajstro	sub-majs-tro
subrido	sub-rido
subskribo	sub-skri-bo
substanco	sub-stan-co
substancoj	sub-stan-c-oj
substancon	sub-stan-c-on
substantiva	sub-stan-ti-va
substantivaj	sub-stan-ti-v-aj
substantivan	sub-stan-ti-v-an
substantivo	sub-stan-ti-vo
substantivoj	sub-stan-ti-v-oj
substantivon	sub-stan-ti-v-on
substrekas	sub-stre-k-as
subŝtatoj	sub-ŝta-t-oj
subŝtofo	sub-ŝto-fo
subtegmento	sub-teg-men-to
subtenadis	sub-te-n-ad-is
subteni	sub-te-ni
subtila	sub-ti-la
subtrahi	sub-tra-hi
subuteo	su-bu-teo
suĉi	su-ĉi
sudafrikajn	sud-af-ri-k-ajn
sudamerikaj	sud-ame-ri-k-aj
sudaŭstraliaj	sud-aŭ-s-tra-li-aj
sudaziaj	sud-azi-aj
sudeŭropa	sud-eŭ-ro-pa
sudo	su-do
sudrusia	sud-ru-sia
sudslava	sud-sla-va
suferi	su-fe-ri
suferiga	su-fe-r-iga
suferigi	su-fe-r-igi
suferigis	su-fe-r-ig-is
suferigos	su-fe-r-ig-os
suferis	su-fe-r-is
suferoj	su-fe-r-oj
suferu	su-fe-ru
sufiĉa	su-fi-ĉa
sufiĉas	su-fi-ĉ-as
sufiĉe	su-fi-ĉe
sufiĉis	su-fi-ĉ-is
sufiĉos	su-fi-ĉ-os
sufikso	su-fik-so
sufiksoj	su-fik-s-oj
sufiksrimo	su-fiks-ri-mo
sufoki	su-fo-ki
sufragano	su-fra-ga-no
sukcesas	suk-ce-s-as
sukcesi	suk-ce-si
sukcesis	suk-ce-s-is
sukceso	suk-ce-so
sukcesos	suk-ce-s-os
sukcesus	suk-ce-s-us
sukeraĵo	su-ke-r-aĵo
sukerbeto	su-ker-b-eto
sukero	su-ke-ro
sukerpecoj	su-ker-pe-c-oj
sukerpecon	su-ker-pe-c-on
sukerujoj	su-ke-r-uj-oj
suko	su-ko
sulfuracido	sul-fu-r-aci-do
sulko	sul-ko
sulo	sulo
sultano	sul-ta-no
suma	su-ma
sumo	su-mo
sunfloro	sun-flo-ro
sunlumo	sun-lumo
suno	su-no
sunon	su-n-on
sunsubiro?	sun-su-biro
super	su-per
superajn	su-per-ajn
superakvi	su-per-ak-vi
supereco	su-per-eco
superflua	su-per-flua
superfluaj	su-per-flu-aj
superfluan	su-per-flu-an
superforto	su-per-for-to
superforton	su-per-for-t-on
superi	su-peri
superis	su-per-is
superjaro	su-per-jaro
superĵetas	su-per-ĵe-t-as
supernacia	su-per-na-cia
supernaturan	su-per-na-tu-r-an
superos	su-per-os
superregis	su-per-re-g-is
supervesto	su-per-ves-to
suplemento	su-ple-men-to
supo	su-po
supon	su-p-on
supozi	su-po-zi
supozita	su-po-z-ita
supozos	su-po-z-os
supozu	su-po-zu
supozus	su-po-z-us
supraĵa	su-pr-aĵa
supraĵe	su-pr-aĵe
supraĵo	su-pr-aĵo
supre	su-pre
supredirita	su-pre-dir-ita
supren	su-pren
supro	su-pro
surbaze	sur-ba-ze
surda	sur-da
surfaca	sur-fa-ca
surfaco	sur-fa-co
surflugi	sur-flu-gi
surkaseda	sur-ka-se-da
surogata	su-ro-ga-ta
surprizi	sur-pri-zi
surŝpruci	sur-ŝpru-ci
surtreti	sur-treti
surtuto	sur-tu-to
survizaĝe	sur-vi-zaĝe
suspektas	su-s-pek-t-as
suspekte	su-s-pek-te
suspekti	su-s-pek-ti
suspektis	su-s-pek-t-is
suspektos	su-s-pek-t-os
suspektu	su-s-pek-tu
suspektus	su-s-pek-t-us
susuri	su-su-ri
svahila	sva-hi-la
svata	svata
sveda	sve-da
svedaj	sve-d-aj
svede	sve-de
svedo	sve-do
svedoj	sve-d-oj
svenas	sve-n-as
sveni	sve-ni
svenis	sve-n-is
sveno	sve-no
svenŝvito	sven-ŝvi-to
svingi	svin-gi
svingĵetis	sving-ĵe-t-is
svingo	svin-go
svisgermano	svis-ger-ma-no
sviso	svi-so
ŝafĉasaĵo	ŝaf-ĉa-s-aĵo
ŝaffelan	ŝaf-fe-l-an
ŝafhundo	ŝaf-hun-do
ŝafkapa	ŝaf-ka-pa
ŝafo	ŝa-fo
ŝafoj	ŝa-f-oj
ŝajnas	ŝaj-n-as
ŝajne	ŝajne
ŝajni	ŝaj-ni
ŝajnigas	ŝaj-n-ig-as
ŝajnis	ŝaj-n-is
ŝajnos	ŝaj-n-os
ŝajnu	ŝaj-nu
ŝakalo	ŝa-ka-lo
ŝamano	ŝa-ma-no
ŝanceli	ŝan-ce-li
ŝanceliĝado	ŝan-ce-l-iĝ-ado
ŝanceliĝi	ŝan-ce-l-iĝi
ŝanceliĝus	ŝan-ce-l-iĝ-us
ŝanco	ŝan-co
ŝancoj	ŝan-c-oj
ŝanĝado	ŝan-ĝ-ado
ŝanĝas	ŝan-ĝ-as
ŝanĝi	ŝan-ĝi
ŝanĝiĝas	ŝan-ĝ-iĝ-as
ŝanĝiĝoj	ŝan-ĝ-iĝ-oj
ŝanĝis	ŝan-ĝ-is
ŝanĝita	ŝan-ĝ-ita
ŝanĝmonero	ŝanĝ-mo-ne-ro
ŝanĝo	ŝan-ĝo
ŝanĝoj	ŝan-ĝ-oj
ŝanĝos	ŝan-ĝ-os
ŝargi	ŝar-gi
ŝarĝo	ŝar-ĝo
ŝatas	ŝa-t-as
ŝategas	ŝa-t-eg-as
ŝati	ŝa-ti
ŝatis	ŝa-t-is
ŝato	ŝato
ŝatos	ŝa-t-os
ŝatus	ŝa-t-us
ŝaŭmakvo?	ŝaŭ-m-ak-vo
ŝaŭmo	ŝaŭ-mo
ŝelŝpato	ŝel-ŝpato
ŝerca	ŝer-ca
ŝercadus	ŝer-c-ad-us
ŝerci	ŝer-ci
ŝerckantetojn	ŝerc-kan-t-et-ojn
ŝevjoto	ŝev-jo-to
ŝia	ŝia
ŝiaflankaj	ŝia-flan-k-aj
ŝiaj	ŝiaj
ŝian	ŝian
ŝiboleto	ŝi-bo-le-to
ŝildknabo	ŝild-kna-bo
ŝilingo	ŝi-lin-go
ŝin	ŝin
ŝindo	ŝindo
ŝinko	ŝin-ko
ŝipano	ŝip-a-no
ŝipe	ŝipe
ŝipestro	ŝip-es-tro
ŝipiri	ŝip-iri
ŝipĵurnalon	ŝip-ĵur-na-l-on
ŝipgvidistoj	ŝip-gvi-d-ist-oj
ŝipo	ŝipo
ŝipoj	ŝip-oj
ŝippereo	ŝip-pe-reo
ŝiprompaĵo	ŝip-rom-p-aĵo
ŝipŝarĝon	ŝip-ŝar-ĝ-on
ŝipveloj	ŝip-ve-l-oj
ŝiras	ŝir-as
ŝiri	ŝiri
ŝirmi	ŝir-mi
ŝjangŝjang	ŝjang-ŝjang
ŝlosi	ŝlo-si
ŝlosilo	ŝlo-s-ilo
ŝlosiloj	ŝlo-s-il-oj
ŝlosilon	ŝlo-s-il-on
ŝlosis	ŝlo-s-is
ŝlosita	ŝlo-s-ita
ŝmato	ŝmato
ŝmiri	ŝmiri
ŝnuro	ŝnu-ro
ŝoforas	ŝo-fo-r-as
ŝofori	ŝo-fo-ri
ŝoforo	ŝo-fo-ro
ŝoveli	ŝo-ve-li
ŝovi	ŝo-vi
ŝovinismo	ŝo-vi-n-ismo
ŝovinistoj	ŝo-vi-n-ist-oj
ŝovitaj	ŝo-v-it-aj
ŝovringo	ŝov-rin-go
ŝparema	ŝpa-r-ema
ŝpari	ŝpa-ri
ŝpini	ŝpi-ni
ŝproso	ŝpro-so
ŝpruci	ŝpru-ci
ŝranko	ŝran-ko
ŝraŭbo	ŝraŭ-bo
ŝtalo	ŝta-lo
ŝtata	ŝta-ta
ŝtatcivitana	ŝtat-ci-vi-ta-na
ŝtato	ŝta-to
ŝtatoj	ŝta-t-oj
ŝtela	ŝtela
ŝteli	ŝteli
ŝteliris	ŝtel-ir-is
ŝtelisto	ŝtel-isto
ŝtelistoj	ŝtel-ist-oj
ŝtelita	ŝtel-ita
ŝtelo	ŝtelo
ŝtelos	ŝtel-os
ŝtipo	ŝti-po
ŝtofo	ŝto-fo
ŝtonĵetilistoj	ŝton-ĵe-ti-l-ist-oj
ŝtono	ŝto-no
ŝtonoj	ŝto-n-oj
ŝtonon	ŝto-n-on
ŝtopi	ŝto-pi
ŝtopos	ŝto-p-os
ŝtormo	ŝtor-mo
ŝtrumpo	ŝtrum-po
ŝtuparo	ŝtu-p-aro
ŝtupeto	ŝtu-peto
ŝtupo	ŝtu-po
ŝuldi	ŝul-di
ŝultro	ŝul-tro
ŝuti	ŝu-ti
ŝutvaroj	ŝut-va-r-oj
ŝvarcvalda	ŝvarc-val-da
ŝveli	ŝve-li
ŝvitbanejo	ŝvit-ba-n-ejo
ŝvitgutoj	ŝvit-gu-t-oj
ŝvito	ŝvi-to
tabako	ta-ba-ko
tabelo	ta-be-lo
tabeloj	ta-be-l-oj
tabelvortoj	ta-bel-vort-oj
tableto	ta-b-l-eto
tablo	ta-b-lo
tablon	ta-b-l-on
tabulo	ta-bu-lo
tabuloj	ta-bu-l-oj
taĉmentojn	taĉ-men-t-ojn
taglaboristo	tag-la-bo-r-isto
taglibro	tag-li-bro
taglumon	tag-lum-on
tagmanĝi	tag-man-ĝi
tagmezo	tag-me-zo
tagnomoj	tag-no-m-oj
tago	ta-go
tagoj	ta-g-oj
tagon	ta-g-on
tajgo	taj-go
tajli	taj-li
tajloro	taj-lo-ro
tajpi	taj-pi
taksi	tak-si
takso	tak-so
taksos	tak-s-os
takto	tak-to
talanto	ta-lan-to
talaro	ta-la-ro
talento	ta-len-to
talenton	ta-len-t-on
talino	ta-li-no
talio	ta-lio
tamarindo	ta-ma-rin-do
tamen	ta-men
tandemo	tan-de-mo
tanino	ta-ni-no
tapeto	ta-peto
tapiŝo	ta-pi-ŝo
tarantulo	ta-ran-tu-lo
tarifo	ta-ri-fo
tasko	ta-s-ko
taskon	ta-s-k-on
tason	ta-s-on
tataroj	ta-ta-r-oj
taŭga	taŭ-ga
taŭgan	taŭ-g-an
taŭgeco	taŭ-g-eco
taŭgus	taŭ-g-us
teatramanto?	te-atra-m-an-to
teatro	te-atro
tedi	te-di
tegi	tegi
tegmento	teg-men-to
tegolo	te-go-lo
teherana	te-he-ra-na
teĥnikaj	teĥ-ni-k-aj
teĥniko	teĥ-ni-ko
teknika	tek-ni-ka
tekniko	tek-ni-ko
tekruĉo	te-kru-ĉo
teksaranĝo?	tek-s-aran-ĝo
teksi	tek-si
teksrulo	teks-rulo
tekstaranĝo	tek-st-aran-ĝo
tekstaro	tek-sta-ro
tekstas	tek-s-t-as
teksto	tek-s-to
tekstoj	tek-s-t-oj
tekstokvanton	tek-s-to-kvan-t-on
tekston	tek-s-t-on
tekstvortoj	tek-st-vort-oj
telefone	te-le-fone
telefono	te-le-fo-no
telegrafo	te-le-gra-fo
telegramo	te-le-gra-mo
telera	te-le-ra
telerforma	te-ler-for-ma
telero	te-le-ro
teleroj	te-le-r-oj
telertuketo	te-ler-tu-k-eto
televidi	te-le-vi-di
televido	te-le-vi-do
temas	te-m-as
temaŝino	te-ma-ŝi-no
temoj	te-m-oj
temperaturo	tem-pe-ra-tu-ro
tempesto	tem-pes-to
tempkalkulon	temp-kal-kul-on
templimo?	tem-pli-mo
templo	tem-plo
tempoj	tem-p-oj
tempon	tem-p-on
tenanto	te-n-an-to
tenas	te-n-as
tendenckontraŭuloj	ten-denc-kon-traŭ-ul-oj
tendenco	ten-den-co
tendo	ten-do
tendon	ten-d-on
tenera	te-ne-ra
teni	te-ni
tenilo	te-n-ilo
tenis	te-n-is
tenti	ten-ti
teofilo	te-o-fi-lo
teon	te-on
teoremo	teo-remo
teoria	te-o-ria
teoriaj	te-o-ri-aj
teorian	te-o-ri-an
teorie	te-o-rie
teorio	te-o-rio
tera	te-ra
terakoto	te-ra-ko-to
teraso	te-ra-so
terebinto	te-re-bin-to
tereno	te-re-no
terenon	te-re-n-on
tergloba	ter-glo-ba
teritorio	te-ri-to-rio
terĵetiĝos	ter-ĵe-t-iĝ-os
terkolo	ter-ko-lo
terminoj	ter-mi-n-oj
termito	ter-mi-to
termometro	ter-mo-me-tro
terni	ter-ni
tero	te-ro
terpomo	ter-po-mo
tertremo	ter-tre-mo
teruran	te-ru-r-an
terure	te-ru-re
teruro	te-ru-ro
testudo	te-stu-do
tiaj	tiaj
tial	tial
tialoj	tial-oj
tiam	tiam
tiamaj	tiam-aj
tiamaniere	tia-ma-ni-e-re
tiamulo	tiam-ulo
tian	tian
tiaspecan	tia-spe-c-an
tibeta	ti-be-ta
tiean	tie-an
tiel	tiel
tien	tien
ties	ties
tiesaĵo	ties-aĵo
tieulo	tie-ulo
tigo	ti-go
tigro	ti-gro
tiĥvinanoj	tiĥ-vi-na-n-oj
tikli	ti-kli
timante	ti-m-an-te
timas	ti-m-as
timegas	ti-m-eg-as
timema	ti-m-ema
timemaj	ti-m-em-aj
timida	ti-mi-da
timigan	ti-m-ig-an
timinda	ti-m-inda
timis	ti-m-is
timo	ti-mo
timu	ti-mu
timulo	ti-m-ulo
timus	ti-m-us
tinkturo	tink-tu-ro
tinto	tin-to
tiom	tiom
tiomaj	tiom-aj
tion	tion
tipo	ti-po
tipoj	ti-p-oj
tipon	ti-p-on
tirano	ti-ra-no
tiri	tiri
tirkesto	tir-kes-to
titollisto	ti-tol-listo
titolo	ti-to-lo
tiudata	tiu-data
tiuj	tiuj
tiun	tiun
tiuokaze	tiu-oka-ze
tiuspeca	tiu-spe-ca
tiutempe	tiu-tem-pe
tokato	to-ka-to
tolaĵo	to-l-aĵo
tolerebla	to-le-r-eb-la
toleri	to-le-ri
tolo	to-lo
tolstoj	tol-stoj
tomato	to-ma-to
tombo	tom-bo
tombon	tom-b-on
tombŝtonaj	tomb-ŝto-n-aj
tondi	ton-di
tondilo	ton-d-ilo
tondro	ton-dro
tono	to-no
tonon	to-n-on
topstajĵibo	top-staj-ĵi-bo
tordi	tor-di
torento	to-ren-to
torto	tor-to
totemo	to-te-mo
tradicio	tra-di-cio
tradicioj	tra-di-ci-oj
tradraŝi	tra-dra-ŝi
tradukadi	tra-du-k-adi
tradukado	tra-du-k-ado
tradukas	tra-du-k-as
tradukata	tra-du-k-ata
tradukeraroj	tra-duk-era-r-oj
traduki	tra-du-ki
tradukis	tra-du-k-is
traduko	tra-du-ko
tradukoj	tra-du-k-oj
tradukojaro	tra-du-ko-jaro
tradukos	tra-du-k-os
traduku	tra-du-ku
trafi	tra-fi
trafiko	trafi-ko
trafoj	tra-f-oj
tragedio	tra-ge-dio
tragika	tra-gi-ka
trairadis	tra-ir-ad-is
trairado	tra-ir-ado
trairi	tra-iri
trajno	traj-no
trajto	traj-to
trakontroli	tra-kon-tro-li
traktato	trak-t-ato
traktatoj	trak-t-at-oj
trakti	trak-ti
traktis	trak-t-is
traktoro	trak-to-ro
trakuri	tra-ku-ri
tralegi	tra-le-gi
tralego	tra-le-go
tralerni	tra-ler-ni
tramo	tra-mo
tranĉas	tran-ĉ-as
tranĉi	tran-ĉi
tranĉilo	tran-ĉ-ilo
tranĉlokojn	tranĉ-lo-k-ojn
trankvila	trank-vi-la
trankvilan	trank-vi-l-an
trankvile	trank-vi-le
trankviligi	trank-vi-l-igi
trankviliĝos	trank-vi-l-iĝ-os
trans	trans
transcenda	trans-cen-da
transepto	tran-sep-to
transformiĝus	trans-for-m-iĝ-us
transigi	trans-igi
transiris	trans-ir-is
transiros	trans-ir-os
transiru	trans-iru
transirus	trans-ir-us
transistoro	tran-sis-to-ro
transitalia	trans-ita-lia
transito	tran-si-to
transĵetita	trans-ĵe-t-ita
transklasigi	trans-kla-s-igi
translacio	trans-la-cio
transmetata	trans-me-t-ata
transmutaciojn	trans-mu-ta-ci-ojn
transpiro	tran-spiro
transportoj	trans-por-t-oj
transskribi	trans-skri-bi
traplektitaj	tra-plek-t-it-aj
trarigardo	trari-gar-do
trarigardos	trari-gar-d-os
trastrekite	tra-stre-k-ite
traŝvebis	tra-ŝve-b-is
travidebla	tra-vi-d-eb-la
travivebla	tra-vi-v-eb-la
travivi	tra-vi-vi
treege	tre-ege
trejni	trej-ni
tremi	tre-mi
tremolo	tre-mo-lo
trempi	trem-pi
treni	tre-ni
trezor	tre-zor
trezoro	tre-zo-ro
trezoron	tre-zo-r-on
trezorserĉantoj	tre-zor-ser-ĉ-an-t-oj
trian	tri-an
triangulo	tri-an-gu-lo
tribunalo	tri-bu-na-lo
trifoje	tri-foje
trifolio	tri-fo-lio
triki	tri-ki
trikoto	tri-ko-to
trikrona	tri-kro-na
trinkaĵon	trin-k-aĵ-on
trinkas	trin-k-as
trinkeblan	trin-k-eb-l-an
trinki	trin-ki
trinkis	trin-k-is
trinko	trin-ko
trinkos	trin-k-os
trinku	trin-ku
trinkus	trin-k-us
triope	tri-ope
trispesmilajn	tri-spes-mi-l-ajn
tritiko	tri-ti-ko
triumfas	tri-um-fas
triumfiro??	tri-um-firo?
triumfkanto	tri-umf-kan-to
triunuo	tri-unuo
trivi	tri-vi
troa	troa
trockianoj	troc-ki-an-oj
troglodito	tro-glo-di-to
trograndigas	tro-grand-ig-as
trograndigo	tro-grand-igo
trompi	trom-pi
trompiĝi	trom-p-iĝi
troto	tro-to
trotuaro	tro-tu-aro
trouzi	tro-uzi
trovaĵo	tro-v-aĵo
trovas	tro-v-as
troveblaj	tro-v-eb-l-aj
troveblas	tro-v-eb-l-as
trovi	tro-vi
troviĝas	tro-v-iĝ-as
troviĝi	tro-v-iĝi
troviĝinta	tro-v-iĝ-in-ta
troviĝis	tro-v-iĝ-is
troviĝos	tro-v-iĝ-os
troviĝu	tro-v-iĝu
trovis	tro-v-is
trovita	tro-v-ita
trovitaj	tro-v-it-aj
trovoj	tro-v-oj
trovos	tro-v-os
trudi	tru-di
trukartoj	tru-kar-t-oj
trulo	tru-lo
trumo	tru-mo
trumpeti	trum-peti
trumpeto	trum-peto
trunkan	trun-k-an
trunketo	trun-k-eto
trunko	trun-ko
trunkon	trun-k-on
truo	truo
trupo	tru-po
tualetakvo	tu-a-let-ak-vo
tualeto	tu-a-leto
tuberkulo	tu-ber-ku-lo
tubero	tu-be-ro
tubeto	tu-b-eto
tubo	tu-bo
tufo	tu-fo
tuko	tu-ko
tulipo	tu-li-po
tumulto	tu-mul-to
tunelo	tu-ne-lo
tungsteno	tung-s-te-no
tuno	tu-no
turbano	tur-ba-no
turbula	tur-bu-la
turismo	tu-r-ismo
turisto	tu-r-isto
turka	tur-ka
turkakafa	tur-ka-ka-fa
turkujo	tur-k-ujo
turmenti	tur-men-ti
turmentiĝas	tur-men-t-iĝ-as
turnas	tur-n-as
turni	tur-ni
turnis	tur-n-is
turnos	tur-n-os
turnu	tur-nu
turo	tu-ro
tusi	tu-si
tusilago	tu-si-la-go
tuŝas	tu-ŝ-as
tuŝi	tu-ŝi
tuŝis	tu-ŝ-is
tuŝu	tu-ŝu
tuta	tuta
tutaj	tut-aj
tutamerika	tut-ame-ri-ka
tutan	tut-an
tutanime	tut-a-ni-me
tutcerte	tut-cer-te
tute	tute
tutegale	tut-ega-le
tuteŭropa	tut-eŭ-ro-pa
tutevidenta	tut-e-vi-den-ta
tutlanaj	tut-la-n-aj
tutlanda	tut-lan-da
tutmonda	tut-mon-da
tutnokte	tut-nok-te
tuton	tut-on
tutorkestra	tut-or-ke-s-tra
tutregna	tut-reg-na
tutsimple	tut-sim-ple
ujigo	uj-igo
ujiĝo	uj-iĝo
ulceretojn	ul-ce-ret-ojn
uleco	ul-eco
ultimato	ul-ti-ma-to
ululo	ulu-lo
umeco	um-eco
ungego	un-g-ego
ungo	un-go
uniformo	uni-for-mo
unika	uni-ka
unisone	uni-sone
universala	uni-ver-sa-la
universaleco	uni-ver-sa-l-eco
universalecon	uni-ver-sa-l-ec-on
universitata	uni-ver-si-ta-ta
universitataj	uni-ver-si-ta-t-aj
universitato	uni-ver-si-ta-to
unua	unua
unuafojan	unua-foj-an
unuaj	unu-aj
unuan	unu-an
unuanime	unu-ani-me
unuataga	unua-ta-ga
unudrata	unu-dra-ta
unue	unue
unueca	unu-eca
unuecgusto	unu-ec-gu-s-to
unuecigon	unu-ec-ig-on
unuenaskito	unue-na-s-k-ito
unuflanke	unu-flan-ke
unufoja	unu-foja
unufoje	unu-foje
unuigo	unu-igo
unuiĝon	unu-iĝ-on
unuj	unuj
unujn	unujn
ununombro	unu-nom-bro
ununura	unu-nu-ra
unuoj	unu-oj
unuopaj	unu-op-aj
unutaga	unu-ta-ga
unuvorte	unu-vorte
upsilo	up-si-lo
urbano	ur-ba-no
urbcentro	urb-cen-tro
urbego	ur-b-ego
urbo	ur-bo
urbocentro	ur-bo-cen-tro
urbĉirkaŭaĵoj	urb-ĉir-kaŭ-aĵ-oj
urbon	ur-b-on
urbparto	urb-par-to
urĝas	ur-ĝ-as
urĝe	ur-ĝe
urĝi	ur-ĝi
urini	uri-ni
urino	uri-no
urso	ur-so
usklecon	us-kl-ec-on
utila	uti-la
utilaj	uti-l-aj
utile	uti-le
utileco	uti-l-eco
utilecon	uti-l-ec-on
utilo	uti-lo
utilon	uti-l-on
utopiistoj	uto-pi-ist-oj
utopio	uto-pio
uvulo	uvu-lo
uzadi	uz-adi
uzado	uz-ado
uzadon	uz-ad-on
uzados	uz-ad-os
uzaĵo	uz-aĵo
uzante	uz-an-te
uzanto	uz-an-to
uzas	uz-as
uzata	uz-ata
uzataj	uz-at-aj
uzateco	uz-at-eco
uzatecon	uz-at-ec-on
uzeblecon	uz-eb-l-ec-on
uziĝas	uz-iĝ-as
uzino	uzi-no
uzinte	uz-in-te
uzis	uz-is
uzita	uz-ita
uzon	uz-on
uzos	uz-os
uzulinterfaco	uzul-in-ter-fa-co
vadi	vadi
vagado	va-g-ado
vagi	va-gi
vagonaro	va-go-n-aro
vagono	va-go-no
vakcinio	vak-ci-nio
vakcino	vak-ci-no
vakso	vak-so
vakstolo	vak-s-to-lo
valida	va-li-da
valizo	va-li-zo
valo	va-lo
valora	va-lo-ra
valoraj	va-lo-r-aj
valoro	va-lo-ro
valoroj	va-lo-r-oj
vana	va-na
vane	vane
vanelo	va-ne-lo
vangharoj	vang-har-oj
vango	van-go
vanilo	va-ni-lo
vanta	van-ta
vaporo	va-po-ro
vaporŝipo	va-por-ŝipo
vaporveturiloj	va-por-ve-tu-r-il-oj
varia	va-ria
variaĵo	va-ri-aĵo
varietato	va-ri-e-t-ato
varii	va-rii
vario	va-rio
varion	va-ri-on
varma	varma
varmaĉan	varm-aĉ-an
varme	varme
varmega	varm-ega
varmegan	varm-eg-an
varmege	varm-ege
varmeta	varm-eta
varo	va-ro
varsoviano	var-so-vi-ano
varti	var-ti
vastan	va-s-t-an
vaste	va-s-te
vastigi	va-s-t-igi
vastigo	va-s-t-igo
vatikana	va-ti-ka-na
vato	vato
vazlavistinoj	vaz-la-v-ist-in-oj
vazo	va-zo
vegetaĵformaj	ve-ge-taĵ-for-m-aj
vegetalo	ve-ge-ta-lo
vegetara	ve-ge-t-ara
vegetas	ve-ge-t-as
vegeto	ve-ge-to
vejno	vej-no
veki	ve-ki
vekiĝanta	ve-k-iĝ-an-ta
vekiĝis	ve-k-iĝ-is
vekis	ve-k-is
velaro	ve-la-ro
velki	vel-ki
velo	ve-lo
velocipedo	ve-lo-ci-pe-do
veluro	ve-lu-ro
venadis	ve-n-ad-is
venas	ve-n-as
vendas	ven-d-as
vendejo	ven-d-ejo
vendeto	ven-de-to
vendi	ven-di
vendredo	ven-dre-do
veneno	ve-ne-no
venĝema	ven-ĝe-ma
venĝi	ven-ĝi
veni	ve-ni
venigi	ve-n-igi
venigis	ve-n-ig-is
venigu	ve-n-igu
venis	ve-n-is
venki	ven-ki
venkitaj	ven-k-it-aj
venonta	ve-n-onta
venontaj	ve-n-ont-aj
venos	ve-n-os
vento	ven-to
ventro	ven-tro
ventumi	ven-t-umi
venu	ve-nu
venus	ve-n-us
vera	ve-ra
veraj	ve-r-aj
verba	ver-ba
verbaj	ver-b-aj
verbo	ver-bo
verbon	ver-b-on
verda	ver-da
verdaj	ver-d-aj
verdire	ver-dire
vere	ve-re
vergo	ver-go
verkanto	ver-kan-to
verki	ver-ki
verkis	ver-k-is
verkisto	ver-k-isto
verko	ver-ko
verkoj	ver-k-oj
verkojaro	ver-ko-jaro
verkon	ver-k-on
vermo	ver-mo
vero	ve-ro
veroj	ve-r-oj
veron	ve-r-on
versfarado	vers-fa-r-ado
versioj	ver-si-oj
verslinio	vers-li-nio
versmezuro	vers-me-zuro
verso	ver-so
verŝajne	ver-ŝajne
verŝi	ver-ŝi
vertico	ver-ti-co
vertiĝo	ver-ti-ĝo
vertikalo	ver-ti-ka-lo
vertikalŝnuro	ver-ti-kal-ŝnu-ro
verto	ver-to
veruko	ve-ru-ko
vespere	ves-pe-re
vespermanĝi	ves-per-man-ĝi
vespermanĝo	ves-per-man-ĝo
vespero	ves-pe-ro
vespo	ve-s-po
vestaĵpendigilo	ves-taĵ-pen-d-ig-ilo
vestaĵoj	ves-t-aĵ-oj
vestiĝoj	ves-ti-ĝ-oj
vestitaj	ves-t-it-aj
vesto	ves-to
vestoj	ves-t-oj
veŝto	ve-ŝ-to
veteranoj	ve-te-ra-n-oj
vetero	ve-te-ro
veti	veti
veton	vet-on
veturado	ve-tu-r-ado
veturas	ve-tu-r-as
veturi	ve-tu-ri
veturigi	ve-tu-r-igi
veturigisto	ve-tu-ri-g-isto
veturigos	ve-tu-r-ig-os
veturigu	ve-tu-r-igu
veturilo	ve-tu-r-ilo
veturiloj	ve-tu-r-il-oj
veturilon	ve-tu-r-il-on
veturis	ve-tu-r-is
veturos	ve-tu-r-os
veturu	ve-tu-ru
veziko	ve-zi-ko
viadukto	via-duk-to
viaj	viaj
vialanda	via-lan-da
vian	vian
viando	vi-an-do
viaspeca	via-spe-ca
viatiko	via-ti-ko
vicĉambelano	vic-ĉam-be-la-no
vicedzino	vic-edzi-no
vicero	vic-e-ro
vicgrafo	vic-gra-fo
vicia	vi-cia
vicigi	vic-igi
vicio	vi-cio
vico	vico
vicon	vic-on
vicpeco	vic-pe-co
viĉjo	vi-ĉjo
vidante	vi-d-an-te
vidas	vi-d-as
videbla	vi-d-eb-la
videblan	vi-d-eb-l-an
videble	vi-d-eb-le
videblis	vi-d-eb-l-is
vidi	vi-di
vidis	vi-d-is
vido	vido
vidon	vid-on
vidos	vi-d-os
vidpunkte	vid-punk-te
vidu	vi-du
vidvino	vid-vi-no
vidvo	vid-vo
vigilo	vi-gi-lo
vigla	vi-gla
vigligus	vi-glig-us
vikingo	vi-kin-go
viktimo	vik-ti-mo
vilaĝanoj	vi-la-ĝa-n-oj
vilaĝo	vi-la-ĝo
vilaj	vil-aj
vilĉjo	vil-ĉjo
vilheĉjo	vil-he-ĉjo
vilhelĉjo	vil-hel-ĉjo
vinbero	vin-be-ro
vindo	vin-do
vinjetoj	vin-jet-oj
vino	vi-no
vintro	vin-tro
violo	vi-o-lo
violono	vi-o-lo-no
vipero	vi-pe-ro
vipfrapo	vip-fra-po
vipo	vi-po
vipuro	vi-pu-ro
viran	vir-an
vireco	vir-eco
virga	virga
virgenro	virgen-ro
virgulino	virg-ul-ino
virinan	vir-i-n-an
virineco	vir-i-n-eco
virino	vir-i-no
virinoj	vir-i-n-oj
virnomo	vir-no-mo
viro	viro
viroj	vir-oj
viron	vir-on
virto	vir-to
virulenta	vi-ru-len-ta
virusoj	viru-s-oj
visto	visto
vistulo	vis-tulo
viŝĉifono	viŝ-ĉi-fo-no
viŝgumon	viŝ-gum-on
viŝi	viŝi
viŝilo	viŝ-ilo
viŝpapero	viŝ-pa-pe-ro
vito	vi-to
vitro	vi-tro
viva	viva
vivaj	viv-aj
vivanta	viv-an-ta
vivantan	viv-an-t-an
vivaranĝo	viv-aran-ĝo
vivas	viv-as
vivcelo	viv-ce-lo
vivdanĝera	viv-dan-ĝe-ra
vivdaŭron	viv-daŭ-r-on
vivfine	viv-fine
vivhistorio	viv-hi-s-to-rio
vivi	vivi
vivipova	vivi-po-va
vivipovaj	vivi-po-v-aj
vivipoveco	vivi-po-v-eco
vivis	viv-is
vivmaniero	viv-ma-ni-e-ro
vivo	vivo
vivoplena	vivo-ple-na
vivoj	viv-oj
vivon	viv-on
vivos	viv-os
vivplena	viv-ple-na
vivsava	viv-sa-va
vivtenado	viv-te-n-ado
vizaĝa	vi-zaĝa
vizaĝesprimo	vi-zaĝ-es-pri-mo
vizaĝo	vi-zaĝo
vizaĝoj	vi-zaĝ-oj
vizitanto	vi-zi-t-an-to
viziti	vi-zi-ti
vizitoj	vi-zi-t-oj
voĉaj	vo-ĉ-aj
voĉdonado	voĉ-do-n-ado
voĉeto	vo-ĉ-eto
voĉlegi	voĉ-le-gi
voĉlegon	voĉ-le-g-on
voĉo	vo-ĉo
voĉon	vo-ĉ-on
voĉsono	voĉ-so-no
voĉtonon	voĉ-to-n-on
vodevilo	vo-de-vi-lo
vojaĉo	vo-j-aĉo
vojaĉon	vo-j-aĉ-on
vojaĝceloj	vo-jaĝ-ce-l-oj
vojaĝi	vo-ja-ĝi
vojaĝkamarado	vo-jaĝ-ka-ma-ra-do
vojaĝlibron	vo-jaĝ-li-br-on
vojaĝo	vo-ja-ĝo
vojeto	vo-j-eto
vojo	vo-jo
vojon	vo-j-on
vokaloj	vo-ka-l-oj
voki	vo-ki
vokis	vo-k-is
voku	vo-ku
volapuka	vo-la-pu-ka
volapukistoj	vo-la-pu-k-ist-oj
volas	vo-l-as
volatila	vo-la-ti-la
voli	vo-li
volis	vo-l-is
volo	vo-lo
volonta	vo-lon-ta
volonteco	vo-lon-t-eco
volos	vo-l-os
volumeno	vo-lu-me-no
volumo	vo-lu-mo
volus	vo-l-us
volvi	vol-vi
volvoplanto	vol-vo-pl-an-to
vomi	vo-mi
vortan	vort-an
vortaranĝo	vort-aran-ĝo
vortaro	vort-aro
vortaroj	vort-ar-oj
vortaron	vort-ar-on
vortelemento	vort-ele-mento
vortetoj	vort-et-oj
vortfarado	vort-fa-r-ado
vortfaradon	vort-fa-r-ad-on
vortfaraj	vort-fa-r-aj
vortfinaĵoj	vort-fi-n-aĵ-oj
vortigi	vort-igi
vortĵetis	vort-ĵe-t-is
vortkonon	vort-ko-n-on
vorto	vorto
vortodivido	vorto-di-vi-do
vortoftecaj	vort-of-t-ec-aj
vortofteco	vort-of-t-eco
vortoj	vort-oj
vorton	vort-on
vortopartetoj	vorto-par-t-et-oj
vortordon	vort-or-d-on
vortourĝa	vorto-ur-ĝa
vortprovizo	vort-pro-vi-zo
vortprovizon	vort-pro-vi-z-on
vortstatistiko	vort-sta-ti-s-ti-ko
vortuzon	vort-uz-on
vosto	vo-s-to
vrakoj	vra-k-oj
vringilo	vrin-g-ilo
vringo	vrin-go
vualo	vu-a-lo
vulgaraĵoj	vul-ga-r-aĵ-oj
vulgaran	vul-ga-r-an
vulgato	vul-ga-to
vulkano	vul-ka-no
vulpo	vul-po
vulturo	vul-tu-ro
vundo	vun-do
waringhien	wa-rin-ghien
zamenhof	za-men-hof
zamenhofa	za-men-ho-fa
zefirlana	ze-fir-la-na
zelotojn	ze-lo-t-ojn
zeniton	ze-ni-t-on
zigzage	zig-za-ge
zinko	zin-ko
zlotoj	zlo-t-oj
zono	zo-no
zoologio	zoo-lo-gio
zooparko	zoo-par-ko
zorgante	zorg-an-te
zorganto	zorg-an-to
zorgas	zorg-as
zorgato	zorg-ato
zorge	zorge
zorgeme	zorg-eme
zorgis	zorg-is
zorgoj	zorg-oj
zorgos	zorg-os
zumi	zumi
PRETE
